cod_ibge,periodos,leitos_total,leitos_hab,leitos_sus,leitos_sus_hab,leitos_nao_sus,leitos_naosus_hab
3500105,2010,308,"9,1",271,8,37,"1,1"
3500204,2010,0,0,0,0,0,0
3500303,2010,76,"2,4",49,"1,5",27,"0,8"
3500402,2010,0,0,0,0,0,0
3500501,2010,42,"2,4",30,"1,7",12,"0,7"
3500550,2010,0,0,0,0,0,0
3500600,2010,0,0,0,0,0,0
3500709,2010,65,"1,9",43,"1,2",22,"0,6"
3500758,2010,0,0,0,0,0,0
3500808,2010,0,0,0,0,0,0
3500907,2010,0,0,0,0,0,0
3501004,2010,30,"1,9",21,"1,3",9,"0,6"
3501103,2010,22,"5,4",19,"4,6",3,"0,7"
3501152,2010,0,0,0,0,0,0
3501202,2010,0,0,0,0,0,0
3501301,2010,20,"0,9",18,"0,8",2,"0,1"
3501400,2010,0,0,0,0,0,0
3501509,2010,0,0,0,0,0,0
3501608,2010,619,"2,9",388,"1,8",231,"1,1"
3501707,2010,240,7,240,7,0,0
3501806,2010,0,0,0,0,0,0
3501905,2010,454,"6,9",356,"5,4",98,"1,5"
3502002,2010,0,0,0,0,0,0
3502101,2010,100,"1,8",64,"1,2",36,"0,7"
3502200,2010,57,"2,6",54,"2,4",3,"0,1"
3502309,2010,0,0,0,0,0,0
3502408,2010,0,0,0,0,0,0
3502507,2010,84,"2,4",50,"1,4",34,1
3502606,2010,30,"6,7",8,"1,8",22,"4,9"
3502705,2010,52,"2,1",46,"1,8",6,"0,2"
3502754,2010,4,"0,2",0,0,4,"0,2"
3502804,2010,660,"3,6",495,"2,7",165,"0,9"
3502903,2010,0,0,0,0,0,0
3503000,2010,0,0,0,0,0,0
3503109,2010,16,"2,6",16,"2,6",0,0
3503158,2010,0,0,0,0,0,0
3503208,2010,504,"2,4",238,"1,1",266,"1,3"
3503307,2010,1137,"9,6",539,"4,5",598,5
3503356,2010,0,0,0,0,0,0
3503406,2010,24,"3,1",22,"2,8",2,"0,3"
3503505,2010,0,0,0,0,0,0
3503604,2010,0,0,0,0,0,0
3503703,2010,25,"2,9",4,"0,5",21,"2,5"
3503802,2010,56,"1,3",0,0,56,"1,3"
3503901,2010,76,1,9,"0,1",67,"0,9"
3503950,2010,0,0,0,0,0,0
3504008,2010,346,"3,6",181,"1,9",165,"1,7"
3504107,2010,187,"1,5",48,"0,4",139,"1,1"
3504206,2010,51,"3,6",30,"2,1",21,"1,5"
3504305,2010,0,0,0,0,0,0
3504404,2010,0,0,0,0,0,0
3504503,2010,153,"1,8",95,"1,1",58,"0,7"
3504602,2010,0,0,0,0,0,0
3504701,2010,0,0,0,0,0,0
3504800,2010,0,0,0,0,0,0
3504909,2010,15,"1,5",15,"1,5",0,0
3505005,2010,0,0,0,0,0,0
3505104,2010,0,0,0,0,0,0
3505203,2010,68,"2,2",52,"1,6",16,"0,5"
3505302,2010,101,"2,9",68,"1,9",33,"0,9"
3505351,2010,0,0,0,0,0,0
3505401,2010,0,0,0,0,0,0
3505500,2010,577,"5,2",457,"4,1",120,"1,1"
3505609,2010,29,1,29,1,0,0
3505708,2010,465,"1,9",382,"1,6",83,"0,3"
3505807,2010,61,3,57,"2,8",4,"0,2"
3505906,2010,139,"2,5",90,"1,6",49,"0,9"
3506003,2010,1148,"3,3",802,"2,3",346,1
3506102,2010,123,"1,6",75,1,48,"0,6"
3506201,2010,0,0,0,0,0,0
3506300,2010,50,"4,6",16,"1,5",34,"3,2"
3506359,2010,51,"1,1",51,"1,1",0,0
3506409,2010,30,"4,3",12,"1,7",18,"2,6"
3506508,2010,251,"2,3",170,"1,6",81,"0,7"
3506607,2010,14,"0,5",14,"0,5",0,0
3506706,2010,15,"1,1",13,1,2,"0,1"
3506805,2010,35,"3,2",30,"2,8",5,"0,5"
3506904,2010,0,0,0,0,0,0
3507001,2010,58,"1,2",42,"0,9",16,"0,3"
3507100,2010,11,"0,6",11,"0,6",0,0
3507159,2010,0,0,0,0,0,0
3507209,2010,0,0,0,0,0,0
3507308,2010,0,0,0,0,0,0
3507407,2010,26,"1,8",16,"1,1",10,"0,7"
3507456,2010,0,0,0,0,0,0
3507506,2010,713,"5,6",590,"4,6",123,1
3507605,2010,326,"2,2",192,"1,3",134,"0,9"
3507704,2010,0,0,0,0,0,0
3507753,2010,0,0,0,0,0,0
3507803,2010,0,0,0,0,0,0
3507902,2010,41,"1,9",35,"1,6",6,"0,3"
3508009,2010,0,0,0,0,0,0
3508108,2010,36,"2,3",22,"1,4",14,"0,9"
3508207,2010,0,0,0,0,0,0
3508306,2010,0,0,0,0,0,0
3508405,2010,36,"0,9",28,"0,7",8,"0,2"
3508504,2010,123,"1,5",67,"0,8",56,"0,7"
3508603,2010,47,"1,6",40,"1,3",7,"0,2"
3508702,2010,75,4,64,"3,5",11,"0,6"
3508801,2010,58,"3,5",47,"2,8",11,"0,7"
3508900,2010,0,0,0,0,0,0
3509007,2010,91,"1,1",29,"0,3",62,"0,7"
3509106,2010,0,0,0,0,0,0
3509205,2010,71,"1,1",71,"1,1",0,0
3509254,2010,13,"0,5",13,"0,5",0,0
3509304,2010,32,"3,3",26,"2,7",6,"0,6"
3509403,2010,68,"2,9",50,"2,1",18,"0,8"
3509452,2010,0,0,0,0,0,0
3509502,2010,2764,"2,6",1407,"1,3",1357,"1,3"
3509601,2010,44,"0,6",44,"0,6",0,0
3509700,2010,444,"9,3",322,"6,7",122,"2,6"
3509809,2010,0,0,0,0,0,0
3509908,2010,0,0,0,0,0,0
3509957,2010,0,0,0,0,0,0
3510005,2010,50,"1,7",40,"1,3",10,"0,3"
3510104,2010,0,0,0,0,0,0
3510153,2010,0,0,0,0,0,0
3510203,2010,100,"2,2",75,"1,6",25,"0,5"
3510302,2010,0,0,0,0,0,0
3510401,2010,119,"2,5",58,"1,2",61,"1,3"
3510500,2010,160,"1,6",122,"1,2",38,"0,4"
3510609,2010,271,"0,7",228,"0,6",43,"0,1"
3510708,2010,31,"2,6",18,"1,5",13,"1,1"
3510807,2010,457,"16,2",440,"15,6",17,"0,6"
3510906,2010,0,0,0,0,0,0
3511003,2010,46,"2,6",30,"1,7",16,"0,9"
3511102,2010,575,"5,1",425,"3,8",150,"1,3"
3511201,2010,0,0,0,0,0,0
3511300,2010,0,0,0,0,0,0
3511409,2010,42,"2,4",33,"1,9",9,"0,5"
3511508,2010,39,1,31,"0,8",8,"0,2"
3511607,2010,30,"1,9",17,"1,1",13,"0,8"
3511706,2010,33,"2,2",26,"1,7",7,"0,5"
3511904,2010,30,"4,3",20,"2,8",10,"1,4"
3512001,2010,47,"2,7",40,"2,3",7,"0,4"
3512100,2010,20,"3,3",20,"3,3",0,0
3512209,2010,60,"2,4",44,"1,7",16,"0,6"
3512308,2010,44,"2,7",37,"2,3",7,"0,4"
3512407,2010,0,0,0,0,0,0
3512506,2010,0,0,0,0,0,0
3512605,2010,0,0,0,0,0,0
3512704,2010,0,0,0,0,0,0
3512803,2010,90,"1,5",61,1,29,"0,5"
3512902,2010,0,0,0,0,0,0
3513009,2010,240,"1,2",176,"0,9",64,"0,3"
3513108,2010,23,"0,7",23,"0,7",0,0
3513207,2010,0,0,0,0,0,0
3513306,2010,0,0,0,0,0,0
3513405,2010,152,2,107,"1,4",45,"0,6"
3513504,2010,150,"1,3",134,"1,1",16,"0,1"
3513603,2010,40,"1,8",24,"1,1",16,"0,7"
3513702,2010,57,"1,8",23,"0,7",34,"1,1"
3513801,2010,565,"1,5",492,"1,3",73,"0,2"
3513850,2010,0,0,0,0,0,0
3513900,2010,204,"18,2",195,"17,4",9,"0,8"
3514007,2010,0,0,0,0,0,0
3514106,2010,65,"2,6",44,"1,8",21,"0,8"
3514205,2010,0,0,0,0,0,0
3514304,2010,18,"2,1",12,"1,4",6,"0,7"
3514403,2010,143,"3,3",108,"2,5",35,"0,8"
3514502,2010,82,"6,7",77,"6,3",5,"0,4"
3514601,2010,0,0,0,0,0,0
3514700,2010,0,0,0,0,0,0
3514809,2010,7,"0,5",7,"0,5",0,0
3514908,2010,6,"0,4",6,"0,4",0,0
3514924,2010,0,0,0,0,0,0
3514957,2010,0,0,0,0,0,0
3515004,2010,81,"0,3",81,"0,3",0,0
3515103,2010,21,"0,3",21,"0,3",0,0
3515129,2010,0,0,0,0,0,0
3515152,2010,0,0,0,0,0,0
3515186,2010,465,"11,1",373,"8,9",92,"2,2"
3515194,2010,0,0,0,0,0,0
3515202,2010,14,"1,7",9,"1,1",5,"0,6"
3515301,2010,0,0,0,0,0,0
3515350,2010,0,0,0,0,0,0
3515400,2010,26,"1,7",17,"1,1",9,"0,6"
3515509,2010,172,"2,7",92,"1,4",80,"1,2"
3515608,2010,0,0,0,0,0,0
3515657,2010,0,0,0,0,0,0
3515707,2010,189,"1,1",189,"1,1",0,0
3515806,2010,0,0,0,0,0,0
3515905,2010,0,0,0,0,0,0
3516002,2010,47,"3,7",30,"2,3",17,"1,3"
3516101,2010,0,0,0,0,0,0
3516200,2010,678,"2,1",418,"1,3",260,"0,8"
3516309,2010,144,"0,9",95,"0,6",49,"0,3"
3516408,2010,635,"4,8",405,"3,1",230,"1,8"
3516507,2010,0,0,0,0,0,0
3516606,2010,45,"6,4",24,"3,4",21,3
3516705,2010,376,"8,7",331,"7,7",45,1
3516804,2010,0,0,0,0,0,0
3516853,2010,0,0,0,0,0,0
3516903,2010,32,3,11,1,21,2
3517000,2010,51,"4,7",42,"3,9",9,"0,8"
3517109,2010,0,0,0,0,0,0
3517208,2010,0,0,0,0,0,0
3517307,2010,0,0,0,0,0,0
3517406,2010,60,"1,6",42,"1,1",18,"0,5"
3517505,2010,0,0,0,0,0,0
3517604,2010,18,1,18,1,0,0
3517703,2010,38,"1,9",30,"1,5",8,"0,4"
3517802,2010,27,"3,2",20,"2,4",7,"0,8"
3517901,2010,0,0,0,0,0,0
3518008,2010,0,0,0,0,0,0
3518107,2010,28,"4,4",24,"3,7",4,"0,6"
3518206,2010,74,"2,4",30,1,44,"1,4"
3518305,2010,35,"1,4",28,"1,1",7,"0,3"
3518404,2010,316,"2,8",274,"2,4",42,"0,4"
3518503,2010,0,0,0,0,0,0
3518602,2010,72,2,51,"1,4",21,"0,6"
3518701,2010,356,"1,2",259,"0,9",97,"0,3"
3518800,2010,1954,"1,6",1429,"1,2",525,"0,4"
3518859,2010,0,0,0,0,0,0
3518909,2010,0,0,0,0,0,0
3519006,2010,23,"2,6",19,"2,2",4,"0,5"
3519055,2010,0,0,0,0,0,0
3519071,2010,75,"0,4",68,"0,4",7,0
3519105,2010,27,"2,7",25,"2,5",2,"0,2"
3519204,2010,15,"2,3",15,"2,3",0,0
3519253,2010,0,0,0,0,0,0
3519303,2010,67,"2,2",62,2,5,"0,2"
3519402,2010,27,"2,5",9,"0,8",18,"1,7"
3519501,2010,0,0,0,0,0,0
3519600,2010,93,"1,8",52,1,41,"0,8"
3519709,2010,16,"0,2",16,"0,2",0,0
3519808,2010,0,0,0,0,0,0
3519907,2010,20,"2,6",20,"2,6",0,0
3520004,2010,67,"2,9",67,"2,9",0,0
3520103,2010,50,"1,8",32,"1,1",18,"0,6"
3520202,2010,15,"1,7",15,"1,7",0,0
3520301,2010,34,"1,2",34,"1,2",0,0
3520400,2010,40,"1,4",37,"1,3",3,"0,1"
3520426,2010,0,0,0,0,0,0
3520442,2010,116,"4,6",74,3,42,"1,7"
3520509,2010,318,"1,6",211,1,107,"0,5"
3520608,2010,0,0,0,0,0,0
3520707,2010,40,"10,2",5,"1,3",35,9
3520806,2010,0,0,0,0,0,0
3520905,2010,49,"3,6",21,"1,5",28,"2,1"
3521002,2010,0,0,0,0,0,0
3521101,2010,0,0,0,0,0,0
3521150,2010,0,0,0,0,0,0
3521200,2010,0,0,0,0,0,0
3521309,2010,48,"3,4",28,2,20,"1,4"
3521408,2010,0,0,0,0,0,0
3521507,2010,0,0,0,0,0,0
3521606,2010,0,0,0,0,0,0
3521705,2010,35,2,30,"1,7",5,"0,3"
3521804,2010,40,"1,7",40,"1,7",0,0
3521903,2010,36,"2,5",15,1,21,"1,4"
3522000,2010,0,0,0,0,0,0
3522109,2010,71,"0,8",71,"0,8",0,0
3522158,2010,0,0,0,0,0,0
3522208,2010,472,"3,1",282,"1,9",190,"1,2"
3522307,2010,127,"0,9",79,"0,5",48,"0,3"
3522406,2010,204,"2,3",153,"1,7",51,"0,6"
3522505,2010,246,"1,2",216,"1,1",30,"0,1"
3522604,2010,1448,"21,1",855,"12,5",593,"8,7"
3522653,2010,0,0,0,0,0,0
3522703,2010,74,"1,8",43,"1,1",31,"0,8"
3522802,2010,49,"3,4",33,"2,3",16,"1,1"
3522901,2010,33,"2,7",22,"1,8",11,"0,9"
3523008,2010,0,0,0,0,0,0
3523107,2010,254,"0,8",224,"0,7",30,"0,1"
3523206,2010,97,2,73,"1,5",24,"0,5"
3523305,2010,0,0,0,0,0,0
3523404,2010,102,1,57,"0,6",45,"0,4"
3523503,2010,14,"0,8",7,"0,4",7,"0,4"
3523602,2010,24,"1,5",20,"1,3",4,"0,3"
3523701,2010,0,0,0,0,0,0
3523800,2010,0,0,0,0,0,0
3523909,2010,503,"3,3",391,"2,5",112,"0,7"
3524006,2010,86,"1,9",48,"1,1",38,"0,9"
3524105,2010,124,"3,2",62,"1,6",62,"1,6"
3524204,2010,23,"3,5",23,"3,5",0,0
3524303,2010,141,2,59,"0,8",82,"1,1"
3524402,2010,418,2,199,"0,9",219,1
3524501,2010,177,"31,4",135,"23,9",42,"7,4"
3524600,2010,0,0,0,0,0,0
3524709,2010,75,"1,7",75,"1,7",0,0
3524808,2010,119,"2,5",70,"1,5",49,1
3524907,2010,0,0,0,0,0,0
3525003,2010,166,"1,5",70,"0,6",96,"0,9"
3525102,2010,0,0,0,0,0,0
3525201,2010,11,"0,5",11,"0,5",0,0
3525300,2010,923,"7,1",728,"5,6",195,"1,5"
3525409,2010,0,0,0,0,0,0
3525508,2010,19,"1,6",19,"1,6",0,0
3525607,2010,0,0,0,0,0,0
3525706,2010,61,"1,9",40,"1,2",21,"0,6"
3525805,2010,0,0,0,0,0,0
3525854,2010,0,0,0,0,0,0
3525904,2010,652,"1,8",280,"0,8",372,1
3526001,2010,52,"2,8",26,"1,4",26,"1,4"
3526100,2010,13,"0,7",13,"0,7",0,0
3526209,2010,24,"0,8",24,"0,8",0,0
3526308,2010,0,0,0,0,0,0
3526407,2010,47,"1,9",33,"1,3",14,"0,6"
3526506,2010,0,0,0,0,0,0
3526605,2010,0,0,0,0,0,0
3526704,2010,127,"1,4",76,"0,8",51,"0,6"
3526803,2010,80,"1,3",55,"0,9",25,"0,4"
3526902,2010,411,"1,5",209,"0,8",202,"0,7"
3527009,2010,0,0,0,0,0,0
3527108,2010,524,"7,3",419,"5,9",105,"1,5"
3527207,2010,160,"1,9",90,"1,1",70,"0,8"
3527256,2010,0,0,0,0,0,0
3527306,2010,27,"0,7",24,"0,6",3,"0,1"
3527405,2010,67,"3,4",48,"2,4",19,1
3527504,2010,0,0,0,0,0,0
3527603,2010,0,0,0,0,0,0
3527702,2010,32,"6,4",15,3,17,"3,4"
3527801,2010,0,0,0,0,0,0
3527900,2010,0,0,0,0,0,0
3528007,2010,31,"1,9",18,"1,1",13,"0,8"
3528106,2010,24,"3,1",5,"0,7",19,"2,5"
3528205,2010,0,0,0,0,0,0
3528304,2010,0,0,0,0,0,0
3528403,2010,0,0,0,0,0,0
3528502,2010,47,"0,6",47,"0,6",0,0
3528601,2010,0,0,0,0,0,0
3528700,2010,0,0,0,0,0,0
3528809,2010,27,2,22,"1,7",5,"0,4"
3528858,2010,0,0,0,0,0,0
3528908,2010,0,0,0,0,0,0
3529005,2010,993,"4,6",755,"3,5",238,"1,1"
3529104,2010,0,0,0,0,0,0
3529203,2010,66,"2,7",41,"1,7",25,1
3529302,2010,140,"1,8",84,"1,1",56,"0,7"
3529401,2010,442,"1,1",236,"0,6",206,"0,5"
3529500,2010,0,0,0,0,0,0
3529609,2010,0,0,0,0,0,0
3529658,2010,0,0,0,0,0,0
3529708,2010,64,"3,1",43,"2,1",21,1
3529807,2010,0,0,0,0,0,0
3529906,2010,16,"0,8",16,"0,8",0,0
3530003,2010,0,0,0,0,0,0
3530102,2010,126,"4,6",96,"3,5",30,"1,1"
3530201,2010,0,0,0,0,0,0
3530300,2010,93,"1,7",24,"0,4",69,"1,3"
3530409,2010,0,0,0,0,0,0
3530508,2010,135,2,98,"1,5",37,"0,6"
3530607,2010,787,2,556,"1,4",231,"0,6"
3530706,2010,269,2,149,"1,1",120,"0,9"
3530805,2010,227,"2,6",138,"1,6",89,1
3530904,2010,0,0,0,0,0,0
3531001,2010,0,0,0,0,0,0
3531100,2010,44,1,44,1,0,0
3531209,2010,0,0,0,0,0,0
3531308,2010,104,"2,2",57,"1,2",47,1
3531407,2010,80,"3,7",35,"1,6",45,"2,1"
3531506,2010,71,"3,7",48,"2,5",23,"1,2"
3531605,2010,0,0,0,0,0,0
3531704,2010,0,0,0,0,0,0
3531803,2010,45,"0,9",38,"0,8",7,"0,1"
3531902,2010,45,"1,5",31,"1,1",14,"0,5"
3532009,2010,27,"2,3",17,"1,4",10,"0,9"
3532058,2010,0,0,0,0,0,0
3532108,2010,22,"5,3",22,"5,3",0,0
3532157,2010,0,0,0,0,0,0
3532207,2010,0,0,0,0,0,0
3532306,2010,0,0,0,0,0,0
3532405,2010,24,"1,5",24,"1,5",0,0
3532504,2010,34,"3,9",11,"1,3",23,"2,6"
3532603,2010,124,"11,6",36,"3,4",88,"8,2"
3532702,2010,0,0,0,0,0,0
3532801,2010,0,0,0,0,0,0
3532827,2010,0,0,0,0,0,0
3532843,2010,0,0,0,0,0,0
3532868,2010,0,0,0,0,0,0
3532900,2010,12,"1,3",7,"0,8",5,"0,5"
3533007,2010,193,"10,1",42,"2,2",151,"7,9"
3533106,2010,0,0,0,0,0,0
3533205,2010,0,0,0,0,0,0
3533254,2010,0,0,0,0,0,0
3533304,2010,0,0,0,0,0,0
3533403,2010,50,1,50,1,0,0
3533502,2010,105,"2,9",38,1,67,"1,8"
3533601,2010,0,0,0,0,0,0
3533700,2010,0,0,0,0,0,0
3533809,2010,0,0,0,0,0,0
3533908,2010,94,"1,9",76,"1,5",18,"0,4"
3534005,2010,0,0,0,0,0,0
3534104,2010,0,0,0,0,0,0
3534203,2010,0,0,0,0,0,0
3534302,2010,118,3,72,"1,8",46,"1,2"
3534401,2010,910,"1,4",509,"0,8",401,"0,6"
3534500,2010,0,0,0,0,0,0
3534609,2010,118,"3,8",71,"2,3",47,"1,5"
3534708,2010,296,"2,9",221,"2,1",75,"0,7"
3534757,2010,39,"4,7",10,"1,2",29,"3,5"
3534807,2010,0,0,0,0,0,0
3534906,2010,32,"2,4",29,"2,2",3,"0,2"
3535002,2010,0,0,0,0,0,0
3535101,2010,0,0,0,0,0,0
3535200,2010,24,"2,5",10,1,14,"1,5"
3535309,2010,68,"3,2",44,"2,1",24,"1,1"
3535408,2010,65,"4,5",45,"3,1",20,"1,4"
3535507,2010,97,"2,3",78,"1,8",19,"0,4"
3535606,2010,24,"1,4",11,"0,6",13,"0,7"
3535705,2010,0,0,0,0,0,0
3535804,2010,30,"1,7",30,"1,7",0,0
3535903,2010,0,0,0,0,0,0
3536000,2010,32,3,26,"2,4",6,"0,6"
3536109,2010,0,0,0,0,0,0
3536208,2010,159,"8,6",159,"8,6",0,0
3536257,2010,0,0,0,0,0,0
3536307,2010,35,"2,7",23,"1,8",12,"0,9"
3536406,2010,0,0,0,0,0,0
3536505,2010,102,"1,2",84,1,18,"0,2"
3536570,2010,0,0,0,0,0,0
3536604,2010,24,"2,8",9,1,15,"1,7"
3536703,2010,67,"1,6",47,"1,1",20,"0,5"
3536802,2010,0,0,0,0,0,0
3536901,2010,0,0,0,0,0,0
3537008,2010,51,"3,2",38,"2,4",13,"0,8"
3537107,2010,49,"1,2",39,"0,9",10,"0,2"
3537156,2010,0,0,0,0,0,0
3537206,2010,0,0,0,0,0,0
3537305,2010,245,"4,2",172,"2,9",73,"1,2"
3537404,2010,98,"3,9",65,"2,6",33,"1,3"
3537503,2010,0,0,0,0,0,0
3537602,2010,44,"0,7",44,"0,7",0,0
3537701,2010,0,0,0,0,0,0
3537800,2010,515,"9,9",511,"9,8",4,"0,1"
3537909,2010,35,"1,3",27,1,8,"0,3"
3538006,2010,204,"1,4",122,"0,8",82,"0,6"
3538105,2010,0,0,0,0,0,0
3538204,2010,0,0,0,0,0,0
3538303,2010,0,0,0,0,0,0
3538501,2010,0,0,0,0,0,0
3538600,2010,35,"1,4",25,1,10,"0,4"
3538709,2010,683,"1,9",293,"0,8",390,"1,1"
3538808,2010,80,"2,8",71,"2,5",9,"0,3"
3538907,2010,153,"6,7",83,"3,7",70,"3,1"
3539004,2010,37,"3,5",9,"0,8",28,"2,6"
3539103,2010,0,0,0,0,0,0
3539202,2010,59,"2,4",59,"2,4",0,0
3539301,2010,110,"1,6",54,"0,8",56,"0,8"
3539400,2010,30,"2,5",26,"2,2",4,"0,3"
3539509,2010,50,"1,4",33,"0,9",17,"0,5"
3539608,2010,0,0,0,0,0,0
3539707,2010,0,0,0,0,0,0
3539806,2010,24,"0,2",24,"0,2",0,0
3539905,2010,0,0,0,0,0,0
3540002,2010,41,"2,1",41,"2,1",0,0
3540101,2010,0,0,0,0,0,0
3540200,2010,75,"1,9",42,1,33,"0,8"
3540259,2010,0,0,0,0,0,0
3540309,2010,0,0,0,0,0,0
3540408,2010,18,"4,3",8,"1,9",10,"2,4"
3540507,2010,0,0,0,0,0,0
3540606,2010,45,"0,9",34,"0,7",11,"0,2"
3540705,2010,61,"1,2",37,"0,7",24,"0,5"
3540754,2010,0,0,0,0,0,0
3540804,2010,28,"1,8",20,"1,3",8,"0,5"
3540853,2010,0,0,0,0,0,0
3540903,2010,0,0,0,0,0,0
3541000,2010,208,"0,8",156,"0,6",52,"0,2"
3541059,2010,0,0,0,0,0,0
3541109,2010,0,0,0,0,0,0
3541208,2010,51,"3,8",40,"2,9",11,"0,8"
3541307,2010,78,"1,9",68,"1,6",10,"0,2"
3541406,2010,1588,"7,7",1079,"5,2",509,"2,5"
3541505,2010,97,"2,6",75,2,22,"0,6"
3541604,2010,78,"2,2",78,"2,2",0,0
3541653,2010,0,0,0,0,0,0
3541703,2010,0,0,0,0,0,0
3541802,2010,0,0,0,0,0,0
3541901,2010,38,"3,4",28,"2,5",10,"0,9"
3542008,2010,0,0,0,0,0,0
3542107,2010,0,0,0,0,0,0
3542206,2010,98,"3,4",70,"2,4",28,1
3542305,2010,0,0,0,0,0,0
3542404,2010,24,"1,3",17,"0,9",7,"0,4"
3542503,2010,0,0,0,0,0,0
3542602,2010,90,"1,7",48,"0,9",42,"0,8"
3542701,2010,0,0,0,0,0,0
3542800,2010,0,0,0,0,0,0
3542909,2010,21,"1,7",9,"0,7",12,1
3543006,2010,39,"2,1",38,"2,1",1,"0,1"
3543105,2010,0,0,0,0,0,0
3543204,2010,0,0,0,0,0,0
3543238,2010,0,0,0,0,0,0
3543253,2010,0,0,0,0,0,0
3543303,2010,128,"1,1",45,"0,4",83,"0,7"
3543402,2010,1896,"3,1",1347,"2,2",549,"0,9"
3543501,2010,0,0,0,0,0,0
3543600,2010,0,0,0,0,0,0
3543709,2010,0,0,0,0,0,0
3543808,2010,33,"3,3",20,2,13,"1,3"
3543907,2010,456,"2,5",276,"1,5",180,1
3544004,2010,60,2,41,"1,4",19,"0,6"
3544103,2010,0,0,0,0,0,0
3544202,2010,36,"3,4",7,"0,7",29,"2,7"
3544251,2010,66,"3,3",58,"2,9",8,"0,4"
3544301,2010,14,"1,5",14,"1,5",0,0
3544400,2010,0,0,0,0,0,0
3544509,2010,0,0,0,0,0,0
3544608,2010,0,0,0,0,0,0
3544707,2010,0,0,0,0,0,0
3544806,2010,0,0,0,0,0,0
3544905,2010,29,"2,7",19,"1,8",10,"0,9"
3545001,2010,24,"1,5",21,"1,3",3,"0,2"
3545100,2010,0,0,0,0,0,0
3545159,2010,0,0,0,0,0,0
3545209,2010,99,"0,9",55,"0,5",44,"0,4"
3545308,2010,1011,"25,2",985,"24,6",26,"0,6"
3545407,2010,34,"3,9",15,"1,7",19,"2,2"
3545506,2010,0,0,0,0,0,0
3545605,2010,31,"2,2",11,"0,8",20,"1,4"
3545704,2010,0,0,0,0,0,0
3545803,2010,126,"0,7",75,"0,4",51,"0,3"
3546009,2010,0,0,0,0,0,0
3546108,2010,0,0,0,0,0,0
3546207,2010,0,0,0,0,0,0
3546256,2010,0,0,0,0,0,0
3546306,2010,46,"1,5",24,"0,8",22,"0,7"
3546405,2010,102,"2,3",59,"1,3",43,1
3546504,2010,0,0,0,0,0,0
3546603,2010,76,"2,6",33,"1,1",43,"1,5"
3546702,2010,0,0,0,0,0,0
3546801,2010,100,2,88,"1,7",12,"0,2"
3546900,2010,0,0,0,0,0,0
3547007,2010,5,"0,9",5,"0,9",0,0
3547106,2010,0,0,0,0,0,0
3547205,2010,0,0,0,0,0,0
3547304,2010,28,"0,3",28,"0,3",0,0
3547403,2010,0,0,0,0,0,0
3547502,2010,299,"11,3",276,"10,4",23,"0,9"
3547601,2010,30,"1,3",18,"0,8",12,"0,5"
3547650,2010,0,0,0,0,0,0
3547700,2010,56,"2,7",37,"1,8",19,"0,9"
3547809,2010,1491,"2,2",637,"0,9",854,"1,3"
3547908,2010,12,"1,9",12,"1,9",0,0
3548005,2010,0,0,0,0,0,0
3548054,2010,0,0,0,0,0,0
3548104,2010,0,0,0,0,0,0
3548203,2010,0,0,0,0,0,0
3548302,2010,0,0,0,0,0,0
3548401,2010,0,0,0,0,0,0
3548500,2010,1692,4,816,"1,9",876,"2,1"
3548609,2010,40,"3,8",24,"2,3",16,"1,5"
3548708,2010,1721,"2,2",836,"1,1",885,"1,2"
3548807,2010,661,"4,4",218,"1,5",443,3
3548906,2010,443,2,204,"0,9",239,"1,1"
3549003,2010,0,0,0,0,0,0
3549102,2010,190,"2,3",84,1,106,"1,3"
3549201,2010,0,0,0,0,0,0
3549250,2010,0,0,0,0,0,0
3549300,2010,0,0,0,0,0,0
3549409,2010,120,"2,6",92,2,28,"0,6"
3549508,2010,0,0,0,0,0,0
3549607,2010,0,0,0,0,0,0
3549706,2010,145,"2,8",89,"1,7",56,"1,1"
3549805,2010,1537,"3,8",1000,"2,5",537,"1,3"
3549904,2010,1467,"2,3",856,"1,4",611,1
3549953,2010,0,0,0,0,0,0
3550001,2010,26,"2,5",11,"1,1",15,"1,4"
3550100,2010,75,2,58,"1,5",17,"0,4"
3550209,2010,6,"0,2",6,"0,2",0,0
3550308,2010,29562,"2,6",15708,"1,4",13854,"1,2"
3550407,2010,81,"2,6",62,2,19,"0,6"
3550506,2010,0,0,0,0,0,0
3550605,2010,94,"1,2",54,"0,7",40,"0,5"
3550704,2010,110,"1,5",99,"1,3",11,"0,1"
3550803,2010,30,"2,5",26,"2,1",4,"0,3"
3550902,2010,40,"2,8",32,"2,2",8,"0,6"
3551009,2010,174,"0,5",134,"0,4",40,"0,1"
3551108,2010,0,0,0,0,0,0
3551207,2010,0,0,0,0,0,0
3551306,2010,0,0,0,0,0,0
3551405,2010,0,0,0,0,0,0
3551504,2010,58,"1,5",43,"1,1",15,"0,4"
3551603,2010,65,"2,5",49,"1,9",16,"0,6"
3551702,2010,155,"1,4",75,"0,7",80,"0,7"
3551801,2010,0,0,0,0,0,0
3551900,2010,0,0,0,0,0,0
3552007,2010,12,"2,1",3,"0,5",9,"1,6"
3552106,2010,62,"1,7",62,"1,7",0,0
3552205,2010,2583,"4,4",2158,"3,7",425,"0,7"
3552304,2010,20,"2,7",20,"2,7",0,0
3552403,2010,184,"0,8",180,"0,7",4,0
3552502,2010,330,"1,3",217,"0,8",113,"0,4"
3552551,2010,0,0,0,0,0,0
3552601,2010,30,"2,6",11,1,19,"1,7"
3552700,2010,35,"2,4",22,"1,5",13,"0,9"
3552809,2010,572,"2,3",338,"1,4",234,1
3552908,2010,0,0,0,0,0,0
3553005,2010,16,"1,5",11,1,5,"0,5"
3553104,2010,0,0,0,0,0,0
3553203,2010,11,2,10,"1,8",1,"0,2"
3553302,2010,36,"1,6",23,1,13,"0,6"
3553401,2010,72,3,38,"1,6",34,"1,4"
3553500,2010,0,0,0,0,0,0
3553609,2010,34,"2,7",21,"1,6",13,1
3553658,2010,0,0,0,0,0,0
3553708,2010,163,3,119,"2,2",44,"0,8"
3553807,2010,53,"2,4",35,"1,6",18,"0,8"
3553856,2010,0,0,0,0,0,0
3553906,2010,0,0,0,0,0,0
3553955,2010,0,0,0,0,0,0
3554003,2010,135,"1,3",90,"0,8",45,"0,4"
3554102,2010,484,"1,7",287,1,197,"0,7"
3554201,2010,0,0,0,0,0,0
3554300,2010,58,"2,7",52,"2,4",6,"0,3"
3554409,2010,34,4,30,"3,5",4,"0,5"
3554508,2010,60,"1,6",35,1,25,"0,7"
3554607,2010,0,0,0,0,0,0
3554656,2010,0,0,0,0,0,0
3554706,2010,20,"2,1",20,"2,1",0,0
3554755,2010,0,0,0,0,0,0
3554805,2010,38,"0,9",19,"0,5",19,"0,5"
3554904,2010,0,0,0,0,0,0
3554953,2010,0,0,0,0,0,0
3555000,2010,881,"13,9",830,"13,1",51,"0,8"
3555109,2010,48,"3,4",30,"2,1",18,"1,3"
3555208,2010,0,0,0,0,0,0
3555307,2010,0,0,0,0,0,0
3555356,2010,0,0,0,0,0,0
3555406,2010,92,"1,2",68,"0,9",24,"0,3"
3555505,2010,0,0,0,0,0,0
3555604,2010,0,0,0,0,0,0
3555703,2010,0,0,0,0,0,0
3555802,2010,38,"4,3",9,1,29,"3,3"
3555901,2010,0,0,0,0,0,0
3556008,2010,34,"2,7",15,"1,2",19,"1,5"
3556107,2010,0,0,0,0,0,0
3556206,2010,165,"1,5",66,"0,6",99,"0,9"
3556305,2010,55,"2,4",31,"1,4",24,"1,1"
3556354,2010,0,0,0,0,0,0
3556404,2010,88,"2,2",53,"1,4",35,"0,9"
3556453,2010,0,0,0,0,0,0
3556503,2010,31,"0,3",31,"0,3",0,0
3556602,2010,0,0,0,0,0,0
3556701,2010,95,"1,5",59,"0,9",36,"0,6"
3556800,2010,54,"3,1",20,"1,2",34,2
3556909,2010,13,"1,9",13,"1,9",0,0
3556958,2010,0,0,0,0,0,0
3557006,2010,171,"1,6",84,"0,8",87,"0,8"
3557105,2010,256,3,118,"1,4",138,"1,6"
3557154,2010,0,0,0,0,0,0
3557204,2010,48,4,20,"1,7",28,"2,3"
3557303,2010,0,0,0,0,0,0
3500105,2011,308,"9,1",271,8,37,"1,1"
3500204,2011,0,0,0,0,0,0
3500303,2011,76,"2,3",49,"1,5",27,"0,8"
3500402,2011,0,0,0,0,0,0
3500501,2011,42,"2,4",30,"1,7",12,"0,7"
3500550,2011,0,0,0,0,0,0
3500600,2011,4,"1,5",4,"1,5",0,0
3500709,2011,65,"1,9",43,"1,2",22,"0,6"
3500758,2011,0,0,0,0,0,0
3500808,2011,0,0,0,0,0,0
3500907,2011,0,0,0,0,0,0
3501004,2011,30,"1,9",21,"1,3",9,"0,6"
3501103,2011,22,"5,4",19,"4,6",3,"0,7"
3501152,2011,0,0,0,0,0,0
3501202,2011,0,0,0,0,0,0
3501301,2011,20,"0,9",18,"0,8",2,"0,1"
3501400,2011,0,0,0,0,0,0
3501509,2011,0,0,0,0,0,0
3501608,2011,677,"3,2",373,"1,8",304,"1,4"
3501707,2011,266,"7,6",266,"7,6",0,0
3501806,2011,0,0,0,0,0,0
3501905,2011,456,"6,9",356,"5,4",100,"1,5"
3502002,2011,0,0,0,0,0,0
3502101,2011,100,"1,8",64,"1,2",36,"0,6"
3502200,2011,57,"2,5",54,"2,4",3,"0,1"
3502309,2011,0,0,0,0,0,0
3502408,2011,0,0,0,0,0,0
3502507,2011,84,"2,4",50,"1,4",34,1
3502606,2011,30,"6,8",8,"1,8",22,5
3502705,2011,47,"1,9",41,"1,6",6,"0,2"
3502754,2011,4,"0,2",0,0,4,"0,2"
3502804,2011,660,"3,6",495,"2,7",165,"0,9"
3502903,2011,0,0,0,0,0,0
3503000,2011,0,0,0,0,0,0
3503109,2011,16,"2,6",16,"2,6",0,0
3503158,2011,0,0,0,0,0,0
3503208,2011,545,"2,6",238,"1,1",307,"1,5"
3503307,2011,1144,"9,5",696,"5,8",448,"3,7"
3503356,2011,0,0,0,0,0,0
3503406,2011,24,3,22,"2,8",2,"0,3"
3503505,2011,0,0,0,0,0,0
3503604,2011,0,0,0,0,0,0
3503703,2011,25,"2,9",4,"0,5",21,"2,4"
3503802,2011,56,"1,2",0,0,56,"1,2"
3503901,2011,82,"1,1",15,"0,2",67,"0,9"
3503950,2011,0,0,0,0,0,0
3504008,2011,342,"3,6",176,"1,8",166,"1,7"
3504107,2011,187,"1,5",48,"0,4",139,"1,1"
3504206,2011,51,"3,6",30,"2,1",21,"1,5"
3504305,2011,0,0,0,0,0,0
3504404,2011,0,0,0,0,0,0
3504503,2011,153,"1,8",95,"1,1",58,"0,7"
3504602,2011,0,0,0,0,0,0
3504701,2011,0,0,0,0,0,0
3504800,2011,0,0,0,0,0,0
3504909,2011,15,"1,5",15,"1,5",0,0
3505005,2011,0,0,0,0,0,0
3505104,2011,0,0,0,0,0,0
3505203,2011,68,"2,1",52,"1,6",16,"0,5"
3505302,2011,101,"2,9",68,"1,9",33,"0,9"
3505351,2011,0,0,0,0,0,0
3505401,2011,0,0,0,0,0,0
3505500,2011,577,"5,1",462,"4,1",115,1
3505609,2011,29,1,29,1,0,0
3505708,2011,478,2,382,"1,6",96,"0,4"
3505807,2011,35,"1,7",28,"1,4",7,"0,3"
3505906,2011,139,"2,4",90,"1,6",49,"0,9"
3506003,2011,1191,"3,4",807,"2,3",384,"1,1"
3506102,2011,140,"1,9",92,"1,2",48,"0,6"
3506201,2011,0,0,0,0,0,0
3506300,2011,50,"4,6",16,"1,5",34,"3,2"
3506359,2011,51,1,51,1,0,0
3506409,2011,35,"4,9",14,2,21,"2,9"
3506508,2011,262,"2,4",170,"1,5",92,"0,8"
3506607,2011,0,0,0,0,0,0
3506706,2011,15,"1,1",13,"0,9",2,"0,1"
3506805,2011,35,"3,2",30,"2,7",5,"0,5"
3506904,2011,0,0,0,0,0,0
3507001,2011,55,"1,1",39,"0,8",16,"0,3"
3507100,2011,11,"0,5",11,"0,5",0,0
3507159,2011,0,0,0,0,0,0
3507209,2011,0,0,0,0,0,0
3507308,2011,0,0,0,0,0,0
3507407,2011,26,"1,8",16,"1,1",10,"0,7"
3507456,2011,0,0,0,0,0,0
3507506,2011,604,"4,7",497,"3,9",107,"0,8"
3507605,2011,326,"2,2",192,"1,3",134,"0,9"
3507704,2011,0,0,0,0,0,0
3507753,2011,0,0,0,0,0,0
3507803,2011,0,0,0,0,0,0
3507902,2011,41,"1,9",35,"1,6",6,"0,3"
3508009,2011,0,0,0,0,0,0
3508108,2011,42,"2,7",22,"1,4",20,"1,3"
3508207,2011,0,0,0,0,0,0
3508306,2011,0,0,0,0,0,0
3508405,2011,38,"0,9",30,"0,7",8,"0,2"
3508504,2011,132,"1,5",63,"0,7",69,"0,8"
3508603,2011,47,"1,6",40,"1,3",7,"0,2"
3508702,2011,75,4,64,"3,4",11,"0,6"
3508801,2011,58,"3,5",47,"2,8",11,"0,7"
3508900,2011,0,0,0,0,0,0
3509007,2011,86,1,37,"0,4",49,"0,6"
3509106,2011,0,0,0,0,0,0
3509205,2011,71,"1,1",71,"1,1",0,0
3509254,2011,13,"0,5",13,"0,5",0,0
3509304,2011,32,"3,3",26,"2,7",6,"0,6"
3509403,2011,68,"2,9",50,"2,1",18,"0,8"
3509452,2011,0,0,0,0,0,0
3509502,2011,2753,"2,5",1375,"1,3",1378,"1,3"
3509601,2011,44,"0,6",44,"0,6",0,0
3509700,2011,444,"9,2",342,"7,1",102,"2,1"
3509809,2011,0,0,0,0,0,0
3509908,2011,0,0,0,0,0,0
3509957,2011,0,0,0,0,0,0
3510005,2011,50,"1,7",40,"1,3",10,"0,3"
3510104,2011,0,0,0,0,0,0
3510153,2011,0,0,0,0,0,0
3510203,2011,95,"2,1",70,"1,5",25,"0,5"
3510302,2011,0,0,0,0,0,0
3510401,2011,119,"2,4",58,"1,2",61,"1,2"
3510500,2011,158,"1,5",120,"1,2",38,"0,4"
3510609,2011,228,"0,6",228,"0,6",0,0
3510708,2011,31,"2,6",18,"1,5",13,"1,1"
3510807,2011,412,"14,5",395,"13,9",17,"0,6"
3510906,2011,0,0,0,0,0,0
3511003,2011,11,"0,6",9,"0,5",2,"0,1"
3511102,2011,575,"5,1",425,"3,8",150,"1,3"
3511201,2011,0,0,0,0,0,0
3511300,2011,0,0,0,0,0,0
3511409,2011,42,"2,4",33,"1,9",9,"0,5"
3511508,2011,39,1,31,"0,8",8,"0,2"
3511607,2011,30,"1,9",17,"1,1",13,"0,8"
3511706,2011,33,"2,2",26,"1,7",7,"0,5"
3511904,2011,30,"4,2",20,"2,8",10,"1,4"
3512001,2011,47,"2,7",40,"2,3",7,"0,4"
3512100,2011,30,5,20,"3,3",10,"1,7"
3512209,2011,55,"2,2",44,"1,7",11,"0,4"
3512308,2011,44,"2,7",37,"2,3",7,"0,4"
3512407,2011,0,0,0,0,0,0
3512506,2011,0,0,0,0,0,0
3512605,2011,0,0,0,0,0,0
3512704,2011,0,0,0,0,0,0
3512803,2011,90,"1,5",61,1,29,"0,5"
3512902,2011,0,0,0,0,0,0
3513009,2011,253,"1,2",189,"0,9",64,"0,3"
3513108,2011,23,"0,7",23,"0,7",0,0
3513207,2011,0,0,0,0,0,0
3513306,2011,0,0,0,0,0,0
3513405,2011,152,2,107,"1,4",45,"0,6"
3513504,2011,150,"1,3",134,"1,1",16,"0,1"
3513603,2011,40,"1,8",24,"1,1",16,"0,7"
3513702,2011,57,"1,8",23,"0,7",34,"1,1"
3513801,2011,567,"1,5",494,"1,3",73,"0,2"
3513850,2011,0,0,0,0,0,0
3513900,2011,204,"18,3",195,"17,4",9,"0,8"
3514007,2011,0,0,0,0,0,0
3514106,2011,65,"2,6",44,"1,8",21,"0,8"
3514205,2011,0,0,0,0,0,0
3514304,2011,18,"2,1",12,"1,4",6,"0,7"
3514403,2011,143,"3,3",108,"2,5",35,"0,8"
3514502,2011,82,"6,7",77,"6,3",5,"0,4"
3514601,2011,0,0,0,0,0,0
3514700,2011,0,0,0,0,0,0
3514809,2011,7,"0,5",7,"0,5",0,0
3514908,2011,6,"0,4",6,"0,4",0,0
3514924,2011,0,0,0,0,0,0
3514957,2011,0,0,0,0,0,0
3515004,2011,83,"0,3",83,"0,3",0,0
3515103,2011,21,"0,3",21,"0,3",0,0
3515129,2011,0,0,0,0,0,0
3515152,2011,0,0,0,0,0,0
3515186,2011,465,"11,1",373,"8,9",92,"2,2"
3515194,2011,0,0,0,0,0,0
3515202,2011,14,"1,7",9,"1,1",5,"0,6"
3515301,2011,0,0,0,0,0,0
3515350,2011,0,0,0,0,0,0
3515400,2011,26,"1,7",17,"1,1",9,"0,6"
3515509,2011,172,"2,7",92,"1,4",80,"1,2"
3515608,2011,0,0,0,0,0,0
3515657,2011,0,0,0,0,0,0
3515707,2011,193,"1,1",193,"1,1",0,0
3515806,2011,0,0,0,0,0,0
3515905,2011,0,0,0,0,0,0
3516002,2011,47,"3,7",30,"2,4",17,"1,3"
3516101,2011,0,0,0,0,0,0
3516200,2011,678,"2,1",418,"1,3",260,"0,8"
3516309,2011,144,"0,9",95,"0,6",49,"0,3"
3516408,2011,670,5,440,"3,3",230,"1,7"
3516507,2011,0,0,0,0,0,0
3516606,2011,45,"6,5",24,"3,4",21,3
3516705,2011,376,"8,7",331,"7,7",45,1
3516804,2011,0,0,0,0,0,0
3516853,2011,0,0,0,0,0,0
3516903,2011,32,3,11,1,21,2
3517000,2011,51,"4,7",42,"3,9",9,"0,8"
3517109,2011,0,0,0,0,0,0
3517208,2011,0,0,0,0,0,0
3517307,2011,0,0,0,0,0,0
3517406,2011,60,"1,6",42,"1,1",18,"0,5"
3517505,2011,0,0,0,0,0,0
3517604,2011,18,1,18,1,0,0
3517703,2011,30,"1,5",22,"1,1",8,"0,4"
3517802,2011,27,"3,2",20,"2,4",7,"0,8"
3517901,2011,0,0,0,0,0,0
3518008,2011,0,0,0,0,0,0
3518107,2011,0,0,0,0,0,0
3518206,2011,74,"2,4",30,1,44,"1,4"
3518305,2011,35,"1,3",28,"1,1",7,"0,3"
3518404,2011,316,"2,8",274,"2,4",42,"0,4"
3518503,2011,0,0,0,0,0,0
3518602,2011,72,2,51,"1,4",21,"0,6"
3518701,2011,306,1,212,"0,7",94,"0,3"
3518800,2011,1859,"1,5",1413,"1,1",446,"0,4"
3518859,2011,0,0,0,0,0,0
3518909,2011,0,0,0,0,0,0
3519006,2011,32,"3,7",19,"2,2",13,"1,5"
3519055,2011,0,0,0,0,0,0
3519071,2011,72,"0,4",65,"0,3",7,0
3519105,2011,27,"2,7",25,"2,5",2,"0,2"
3519204,2011,15,"2,3",15,"2,3",0,0
3519253,2011,0,0,0,0,0,0
3519303,2011,23,"0,7",23,"0,7",0,0
3519402,2011,27,"2,5",9,"0,8",18,"1,6"
3519501,2011,0,0,0,0,0,0
3519600,2011,93,"1,7",52,1,41,"0,8"
3519709,2011,32,"0,4",32,"0,4",0,0
3519808,2011,0,0,0,0,0,0
3519907,2011,20,"2,6",20,"2,6",0,0
3520004,2011,63,"2,7",55,"2,3",8,"0,3"
3520103,2011,50,"1,8",32,"1,1",18,"0,6"
3520202,2011,15,"1,7",15,"1,7",0,0
3520301,2011,34,"1,2",34,"1,2",0,0
3520400,2011,40,"1,4",37,"1,3",3,"0,1"
3520426,2011,0,0,0,0,0,0
3520442,2011,116,"4,6",74,"2,9",42,"1,7"
3520509,2011,326,"1,6",230,"1,1",96,"0,5"
3520608,2011,0,0,0,0,0,0
3520707,2011,40,"10,3",5,"1,3",35,9
3520806,2011,0,0,0,0,0,0
3520905,2011,49,"3,6",21,"1,5",28,2
3521002,2011,0,0,0,0,0,0
3521101,2011,0,0,0,0,0,0
3521150,2011,0,0,0,0,0,0
3521200,2011,0,0,0,0,0,0
3521309,2011,48,"3,4",28,2,20,"1,4"
3521408,2011,0,0,0,0,0,0
3521507,2011,0,0,0,0,0,0
3521606,2011,0,0,0,0,0,0
3521705,2011,35,2,30,"1,7",5,"0,3"
3521804,2011,41,"1,7",40,"1,7",1,0
3521903,2011,36,"2,5",15,1,21,"1,4"
3522000,2011,0,0,0,0,0,0
3522109,2011,77,"0,9",77,"0,9",0,0
3522158,2011,0,0,0,0,0,0
3522208,2011,472,"3,1",282,"1,8",190,"1,2"
3522307,2011,129,"0,9",93,"0,6",36,"0,2"
3522406,2011,204,"2,3",153,"1,7",51,"0,6"
3522505,2011,254,"1,2",205,1,49,"0,2"
3522604,2011,1452,"21,1",839,"12,2",613,"8,9"
3522653,2011,0,0,0,0,0,0
3522703,2011,74,"1,8",46,"1,1",28,"0,7"
3522802,2011,49,"3,4",33,"2,3",16,"1,1"
3522901,2011,33,"2,7",22,"1,8",11,"0,9"
3523008,2011,0,0,0,0,0,0
3523107,2011,254,"0,8",224,"0,7",30,"0,1"
3523206,2011,97,2,73,"1,5",24,"0,5"
3523305,2011,0,0,0,0,0,0
3523404,2011,112,"1,1",60,"0,6",52,"0,5"
3523503,2011,14,"0,8",7,"0,4",7,"0,4"
3523602,2011,24,"1,5",20,"1,3",4,"0,3"
3523701,2011,0,0,0,0,0,0
3523800,2011,0,0,0,0,0,0
3523909,2011,426,"2,7",391,"2,5",35,"0,2"
3524006,2011,86,"1,9",48,1,38,"0,8"
3524105,2011,120,"3,1",58,"1,5",62,"1,6"
3524204,2011,23,"3,5",23,"3,5",0,0
3524303,2011,122,"1,7",51,"0,7",71,1
3524402,2011,383,"1,8",179,"0,8",204,1
3524501,2011,177,"30,6",135,"23,4",42,"7,3"
3524600,2011,0,0,0,0,0,0
3524709,2011,75,"1,7",75,"1,7",0,0
3524808,2011,129,"2,7",70,"1,5",59,"1,3"
3524907,2011,0,0,0,0,0,0
3525003,2011,35,"0,3",31,"0,3",4,0
3525102,2011,0,0,0,0,0,0
3525201,2011,12,"0,5",12,"0,5",0,0
3525300,2011,922,7,735,"5,5",187,"1,4"
3525409,2011,0,0,0,0,0,0
3525508,2011,24,2,17,"1,4",7,"0,6"
3525607,2011,0,0,0,0,0,0
3525706,2011,61,"1,8",40,"1,2",21,"0,6"
3525805,2011,0,0,0,0,0,0
3525854,2011,0,0,0,0,0,0
3525904,2011,640,"1,7",281,"0,8",359,1
3526001,2011,52,"2,8",26,"1,4",26,"1,4"
3526100,2011,17,"0,9",17,"0,9",0,0
3526209,2011,24,"0,8",24,"0,8",0,0
3526308,2011,0,0,0,0,0,0
3526407,2011,47,"1,8",33,"1,3",14,"0,5"
3526506,2011,0,0,0,0,0,0
3526605,2011,0,0,0,0,0,0
3526704,2011,127,"1,4",76,"0,8",51,"0,6"
3526803,2011,80,"1,3",57,"0,9",23,"0,4"
3526902,2011,400,"1,4",203,"0,7",197,"0,7"
3527009,2011,0,0,0,0,0,0
3527108,2011,484,"6,7",379,"5,3",105,"1,5"
3527207,2011,160,"1,9",90,"1,1",70,"0,8"
3527256,2011,0,0,0,0,0,0
3527306,2011,27,"0,7",24,"0,6",3,"0,1"
3527405,2011,67,"3,4",48,"2,4",19,1
3527504,2011,0,0,0,0,0,0
3527603,2011,0,0,0,0,0,0
3527702,2011,32,"6,3",15,"2,9",17,"3,3"
3527801,2011,0,0,0,0,0,0
3527900,2011,0,0,0,0,0,0
3528007,2011,31,"1,9",18,"1,1",13,"0,8"
3528106,2011,24,"3,1",5,"0,7",19,"2,5"
3528205,2011,0,0,0,0,0,0
3528304,2011,0,0,0,0,0,0
3528403,2011,0,0,0,0,0,0
3528502,2011,47,"0,6",47,"0,6",0,0
3528601,2011,0,0,0,0,0,0
3528700,2011,0,0,0,0,0,0
3528809,2011,27,2,22,"1,6",5,"0,4"
3528858,2011,0,0,0,0,0,0
3528908,2011,0,0,0,0,0,0
3529005,2011,887,"4,1",728,"3,3",159,"0,7"
3529104,2011,0,0,0,0,0,0
3529203,2011,66,"2,7",41,"1,7",25,1
3529302,2011,140,"1,8",84,"1,1",56,"0,7"
3529401,2011,442,1,236,"0,6",206,"0,5"
3529500,2011,0,0,0,0,0,0
3529609,2011,0,0,0,0,0,0
3529658,2011,0,0,0,0,0,0
3529708,2011,64,"3,1",43,"2,1",21,1
3529807,2011,0,0,0,0,0,0
3529906,2011,16,"0,8",16,"0,8",0,0
3530003,2011,0,0,0,0,0,0
3530102,2011,126,"4,6",96,"3,5",30,"1,1"
3530201,2011,0,0,0,0,0,0
3530300,2011,93,"1,7",24,"0,4",69,"1,3"
3530409,2011,0,0,0,0,0,0
3530508,2011,140,"2,1",98,"1,5",42,"0,6"
3530607,2011,742,"1,9",551,"1,4",191,"0,5"
3530706,2011,269,"1,9",149,"1,1",120,"0,9"
3530805,2011,264,3,140,"1,6",124,"1,4"
3530904,2011,0,0,0,0,0,0
3531001,2011,0,0,0,0,0,0
3531100,2011,44,"0,9",44,"0,9",0,0
3531209,2011,0,0,0,0,0,0
3531308,2011,109,"2,3",58,"1,2",51,"1,1"
3531407,2011,80,"3,6",35,"1,6",45,"2,1"
3531506,2011,67,"3,6",47,"2,5",20,"1,1"
3531605,2011,0,0,0,0,0,0
3531704,2011,0,0,0,0,0,0
3531803,2011,45,"0,9",38,"0,8",7,"0,1"
3531902,2011,45,"1,5",31,"1,1",14,"0,5"
3532009,2011,40,"3,4",30,"2,5",10,"0,8"
3532058,2011,0,0,0,0,0,0
3532108,2011,22,"5,2",22,"5,2",0,0
3532157,2011,0,0,0,0,0,0
3532207,2011,0,0,0,0,0,0
3532306,2011,0,0,0,0,0,0
3532405,2011,24,"1,4",24,"1,4",0,0
3532504,2011,34,"3,9",11,"1,3",23,"2,6"
3532603,2011,124,"11,6",36,"3,4",88,"8,2"
3532702,2011,0,0,0,0,0,0
3532801,2011,0,0,0,0,0,0
3532827,2011,0,0,0,0,0,0
3532843,2011,0,0,0,0,0,0
3532868,2011,0,0,0,0,0,0
3532900,2011,12,"1,3",7,"0,7",5,"0,5"
3533007,2011,193,10,42,"2,2",151,"7,8"
3533106,2011,0,0,0,0,0,0
3533205,2011,0,0,0,0,0,0
3533254,2011,0,0,0,0,0,0
3533304,2011,0,0,0,0,0,0
3533403,2011,50,1,50,1,0,0
3533502,2011,105,"2,9",38,1,67,"1,8"
3533601,2011,0,0,0,0,0,0
3533700,2011,0,0,0,0,0,0
3533809,2011,0,0,0,0,0,0
3533908,2011,94,"1,9",76,"1,5",18,"0,4"
3534005,2011,0,0,0,0,0,0
3534104,2011,0,0,0,0,0,0
3534203,2011,0,0,0,0,0,0
3534302,2011,118,"2,9",72,"1,8",46,"1,1"
3534401,2011,950,"1,4",616,"0,9",334,"0,5"
3534500,2011,0,0,0,0,0,0
3534609,2011,118,"3,8",71,"2,3",47,"1,5"
3534708,2011,315,3,230,"2,2",85,"0,8"
3534757,2011,39,"4,6",10,"1,2",29,"3,4"
3534807,2011,0,0,0,0,0,0
3534906,2011,32,"2,4",29,"2,2",3,"0,2"
3535002,2011,0,0,0,0,0,0
3535101,2011,0,0,0,0,0,0
3535200,2011,24,"2,5",10,1,14,"1,5"
3535309,2011,68,"3,2",44,"2,1",24,"1,1"
3535408,2011,65,"4,4",45,"3,1",20,"1,4"
3535507,2011,97,"2,3",78,"1,8",19,"0,4"
3535606,2011,14,"0,8",12,"0,7",2,"0,1"
3535705,2011,0,0,0,0,0,0
3535804,2011,30,"1,7",30,"1,7",0,0
3535903,2011,0,0,0,0,0,0
3536000,2011,32,3,26,"2,4",6,"0,6"
3536109,2011,0,0,0,0,0,0
3536208,2011,159,"8,6",159,"8,6",0,0
3536257,2011,0,0,0,0,0,0
3536307,2011,35,"2,7",23,"1,8",12,"0,9"
3536406,2011,0,0,0,0,0,0
3536505,2011,84,1,84,1,0,0
3536570,2011,0,0,0,0,0,0
3536604,2011,24,"2,8",9,1,15,"1,7"
3536703,2011,67,"1,6",47,"1,1",20,"0,5"
3536802,2011,0,0,0,0,0,0
3536901,2011,0,0,0,0,0,0
3537008,2011,52,"3,3",32,2,20,"1,3"
3537107,2011,49,"1,2",39,"0,9",10,"0,2"
3537156,2011,0,0,0,0,0,0
3537206,2011,0,0,0,0,0,0
3537305,2011,241,"4,1",168,"2,9",73,"1,2"
3537404,2011,98,"3,9",65,"2,6",33,"1,3"
3537503,2011,0,0,0,0,0,0
3537602,2011,43,"0,7",43,"0,7",0,0
3537701,2011,0,0,0,0,0,0
3537800,2011,515,"9,9",511,"9,8",4,"0,1"
3537909,2011,35,"1,3",27,1,8,"0,3"
3538006,2011,195,"1,3",117,"0,8",78,"0,5"
3538105,2011,0,0,0,0,0,0
3538204,2011,0,0,0,0,0,0
3538303,2011,0,0,0,0,0,0
3538501,2011,0,0,0,0,0,0
3538600,2011,35,"1,4",25,1,10,"0,4"
3538709,2011,807,"2,2",316,"0,9",491,"1,3"
3538808,2011,80,"2,8",71,"2,5",9,"0,3"
3538907,2011,153,"6,7",83,"3,6",70,"3,1"
3539004,2011,37,"3,5",9,"0,8",28,"2,6"
3539103,2011,0,0,0,0,0,0
3539202,2011,59,"2,4",59,"2,4",0,0
3539301,2011,86,"1,2",52,"0,7",34,"0,5"
3539400,2011,30,"2,5",26,"2,1",4,"0,3"
3539509,2011,50,"1,4",32,"0,9",18,"0,5"
3539608,2011,0,0,0,0,0,0
3539707,2011,0,0,0,0,0,0
3539806,2011,14,"0,1",14,"0,1",0,0
3539905,2011,0,0,0,0,0,0
3540002,2011,41,2,41,2,0,0
3540101,2011,0,0,0,0,0,0
3540200,2011,75,"1,8",45,"1,1",30,"0,7"
3540259,2011,0,0,0,0,0,0
3540309,2011,0,0,0,0,0,0
3540408,2011,18,"4,3",8,"1,9",10,"2,4"
3540507,2011,0,0,0,0,0,0
3540606,2011,45,"0,9",34,"0,7",11,"0,2"
3540705,2011,61,"1,2",37,"0,7",24,"0,5"
3540754,2011,0,0,0,0,0,0
3540804,2011,28,"1,8",20,"1,3",8,"0,5"
3540853,2011,0,0,0,0,0,0
3540903,2011,0,0,0,0,0,0
3541000,2011,199,"0,7",113,"0,4",86,"0,3"
3541059,2011,0,0,0,0,0,0
3541109,2011,0,0,0,0,0,0
3541208,2011,51,"3,8",40,"2,9",11,"0,8"
3541307,2011,78,"1,9",68,"1,6",10,"0,2"
3541406,2011,1578,"7,6",1094,"5,2",484,"2,3"
3541505,2011,97,"2,6",75,2,22,"0,6"
3541604,2011,78,"2,2",78,"2,2",0,0
3541653,2011,0,0,0,0,0,0
3541703,2011,0,0,0,0,0,0
3541802,2011,0,0,0,0,0,0
3541901,2011,26,"2,3",26,"2,3",0,0
3542008,2011,0,0,0,0,0,0
3542107,2011,0,0,0,0,0,0
3542206,2011,98,"3,4",70,"2,4",28,1
3542305,2011,0,0,0,0,0,0
3542404,2011,24,"1,3",17,"0,9",7,"0,4"
3542503,2011,0,0,0,0,0,0
3542602,2011,90,"1,7",48,"0,9",42,"0,8"
3542701,2011,0,0,0,0,0,0
3542800,2011,0,0,0,0,0,0
3542909,2011,21,"1,7",9,"0,7",12,1
3543006,2011,39,"2,1",38,"2,1",1,"0,1"
3543105,2011,0,0,0,0,0,0
3543204,2011,0,0,0,0,0,0
3543238,2011,0,0,0,0,0,0
3543253,2011,0,0,0,0,0,0
3543303,2011,164,"1,4",50,"0,4",114,1
3543402,2011,1920,"3,1",1365,"2,2",555,"0,9"
3543501,2011,0,0,0,0,0,0
3543600,2011,0,0,0,0,0,0
3543709,2011,0,0,0,0,0,0
3543808,2011,33,"3,3",20,2,13,"1,3"
3543907,2011,488,"2,6",270,"1,4",218,"1,2"
3544004,2011,60,2,41,"1,4",19,"0,6"
3544103,2011,0,0,0,0,0,0
3544202,2011,36,"3,4",7,"0,7",29,"2,7"
3544251,2011,66,"3,4",58,3,8,"0,4"
3544301,2011,14,"1,4",14,"1,4",0,0
3544400,2011,0,0,0,0,0,0
3544509,2011,0,0,0,0,0,0
3544608,2011,0,0,0,0,0,0
3544707,2011,0,0,0,0,0,0
3544806,2011,0,0,0,0,0,0
3544905,2011,29,"2,7",19,"1,8",10,"0,9"
3545001,2011,24,"1,5",21,"1,3",3,"0,2"
3545100,2011,0,0,0,0,0,0
3545159,2011,0,0,0,0,0,0
3545209,2011,123,"1,2",69,"0,6",54,"0,5"
3545308,2011,1011,25,985,"24,3",26,"0,6"
3545407,2011,34,"3,9",15,"1,7",19,"2,2"
3545506,2011,0,0,0,0,0,0
3545605,2011,31,"2,2",11,"0,8",20,"1,4"
3545704,2011,0,0,0,0,0,0
3545803,2011,126,"0,7",75,"0,4",51,"0,3"
3546009,2011,0,0,0,0,0,0
3546108,2011,0,0,0,0,0,0
3546207,2011,0,0,0,0,0,0
3546256,2011,0,0,0,0,0,0
3546306,2011,44,"1,5",23,"0,8",21,"0,7"
3546405,2011,102,"2,3",59,"1,3",43,1
3546504,2011,0,0,0,0,0,0
3546603,2011,76,"2,6",33,"1,1",43,"1,5"
3546702,2011,0,0,0,0,0,0
3546801,2011,100,2,88,"1,7",12,"0,2"
3546900,2011,0,0,0,0,0,0
3547007,2011,5,"0,9",5,"0,9",0,0
3547106,2011,0,0,0,0,0,0
3547205,2011,0,0,0,0,0,0
3547304,2011,28,"0,3",28,"0,3",0,0
3547403,2011,0,0,0,0,0,0
3547502,2011,299,"11,3",276,"10,4",23,"0,9"
3547601,2011,30,"1,2",18,"0,7",12,"0,5"
3547650,2011,0,0,0,0,0,0
3547700,2011,56,"2,7",37,"1,8",19,"0,9"
3547809,2011,1450,"2,1",604,"0,9",846,"1,2"
3547908,2011,12,"1,9",12,"1,9",0,0
3548005,2011,0,0,0,0,0,0
3548054,2011,0,0,0,0,0,0
3548104,2011,0,0,0,0,0,0
3548203,2011,0,0,0,0,0,0
3548302,2011,0,0,0,0,0,0
3548401,2011,0,0,0,0,0,0
3548500,2011,1624,"3,9",734,"1,7",890,"2,1"
3548609,2011,40,"3,8",24,"2,3",16,"1,5"
3548708,2011,1631,"2,1",761,1,870,"1,1"
3548807,2011,529,"3,5",150,1,379,"2,5"
3548906,2011,443,2,204,"0,9",239,"1,1"
3549003,2011,0,0,0,0,0,0
3549102,2011,190,"2,3",84,1,106,"1,3"
3549201,2011,0,0,0,0,0,0
3549250,2011,0,0,0,0,0,0
3549300,2011,0,0,0,0,0,0
3549409,2011,115,"2,5",68,"1,5",47,1
3549508,2011,0,0,0,0,0,0
3549607,2011,0,0,0,0,0,0
3549706,2011,145,"2,8",89,"1,7",56,"1,1"
3549805,2011,1690,"4,1",1146,"2,8",544,"1,3"
3549904,2011,1459,"2,3",829,"1,3",630,1
3549953,2011,0,0,0,0,0,0
3550001,2011,26,"2,5",11,"1,1",15,"1,4"
3550100,2011,34,"0,9",22,"0,6",12,"0,3"
3550209,2011,6,"0,2",6,"0,2",0,0
3550308,2011,29497,"2,6",15657,"1,4",13840,"1,2"
3550407,2011,62,"1,9",37,"1,2",25,"0,8"
3550506,2011,0,0,0,0,0,0
3550605,2011,104,"1,3",54,"0,7",50,"0,6"
3550704,2011,110,"1,5",99,"1,3",11,"0,1"
3550803,2011,30,"2,5",26,"2,2",4,"0,3"
3550902,2011,40,"2,8",32,"2,2",8,"0,6"
3551009,2011,218,"0,7",166,"0,5",52,"0,2"
3551108,2011,0,0,0,0,0,0
3551207,2011,0,0,0,0,0,0
3551306,2011,0,0,0,0,0,0
3551405,2011,0,0,0,0,0,0
3551504,2011,58,"1,5",43,"1,1",15,"0,4"
3551603,2011,55,"2,1",42,"1,6",13,"0,5"
3551702,2011,155,"1,4",75,"0,7",80,"0,7"
3551801,2011,0,0,0,0,0,0
3551900,2011,0,0,0,0,0,0
3552007,2011,12,"2,1",3,"0,5",9,"1,5"
3552106,2011,62,"1,7",54,"1,5",8,"0,2"
3552205,2011,2588,"4,4",2158,"3,6",430,"0,7"
3552304,2011,20,"2,7",20,"2,7",0,0
3552403,2011,184,"0,8",180,"0,7",4,0
3552502,2011,188,"0,7",119,"0,4",69,"0,3"
3552551,2011,0,0,0,0,0,0
3552601,2011,30,"2,6",11,1,19,"1,7"
3552700,2011,35,"2,4",22,"1,5",13,"0,9"
3552809,2011,569,"2,3",338,"1,4",231,"0,9"
3552908,2011,0,0,0,0,0,0
3553005,2011,16,"1,4",11,1,5,"0,5"
3553104,2011,0,0,0,0,0,0
3553203,2011,11,"1,9",10,"1,7",1,"0,2"
3553302,2011,36,"1,6",23,1,13,"0,6"
3553401,2011,72,3,38,"1,6",34,"1,4"
3553500,2011,0,0,0,0,0,0
3553609,2011,34,"2,7",21,"1,7",13,1
3553658,2011,0,0,0,0,0,0
3553708,2011,163,3,119,"2,2",44,"0,8"
3553807,2011,55,"2,5",36,"1,6",19,"0,8"
3553856,2011,0,0,0,0,0,0
3553906,2011,0,0,0,0,0,0
3553955,2011,0,0,0,0,0,0
3554003,2011,135,"1,2",90,"0,8",45,"0,4"
3554102,2011,499,"1,8",299,"1,1",200,"0,7"
3554201,2011,0,0,0,0,0,0
3554300,2011,58,"2,7",52,"2,4",6,"0,3"
3554409,2011,34,4,30,"3,5",4,"0,5"
3554508,2011,60,"1,6",35,"0,9",25,"0,7"
3554607,2011,0,0,0,0,0,0
3554656,2011,0,0,0,0,0,0
3554706,2011,20,"2,1",20,"2,1",0,0
3554755,2011,0,0,0,0,0,0
3554805,2011,38,"0,9",19,"0,5",19,"0,5"
3554904,2011,0,0,0,0,0,0
3554953,2011,0,0,0,0,0,0
3555000,2011,872,"13,8",798,"12,6",74,"1,2"
3555109,2011,48,"3,3",30,"2,1",18,"1,3"
3555208,2011,0,0,0,0,0,0
3555307,2011,0,0,0,0,0,0
3555356,2011,0,0,0,0,0,0
3555406,2011,92,"1,2",68,"0,9",24,"0,3"
3555505,2011,0,0,0,0,0,0
3555604,2011,0,0,0,0,0,0
3555703,2011,0,0,0,0,0,0
3555802,2011,38,"4,3",9,1,29,"3,3"
3555901,2011,0,0,0,0,0,0
3556008,2011,34,"2,7",15,"1,2",19,"1,5"
3556107,2011,0,0,0,0,0,0
3556206,2011,165,"1,5",66,"0,6",99,"0,9"
3556305,2011,55,"2,4",31,"1,4",24,"1,1"
3556354,2011,0,0,0,0,0,0
3556404,2011,88,"2,2",53,"1,3",35,"0,9"
3556453,2011,0,0,0,0,0,0
3556503,2011,31,"0,3",31,"0,3",0,0
3556602,2011,0,0,0,0,0,0
3556701,2011,95,"1,5",59,"0,9",36,"0,6"
3556800,2011,54,"3,1",20,"1,1",34,2
3556909,2011,9,"1,3",9,"1,3",0,0
3556958,2011,0,0,0,0,0,0
3557006,2011,146,"1,3",84,"0,8",62,"0,6"
3557105,2011,240,"2,8",118,"1,4",122,"1,4"
3557154,2011,0,0,0,0,0,0
3557204,2011,48,4,20,"1,6",28,"2,3"
3557303,2011,0,0,0,0,0,0
3500105,2012,300,"8,9",263,"7,8",37,"1,1"
3500204,2012,0,0,0,0,0,0
3500303,2012,76,"2,3",49,"1,5",27,"0,8"
3500402,2012,0,0,0,0,0,0
3500501,2012,42,"2,4",30,"1,7",12,"0,7"
3500550,2012,0,0,0,0,0,0
3500600,2012,4,"1,4",4,"1,4",0,0
3500709,2012,65,"1,9",43,"1,2",22,"0,6"
3500758,2012,0,0,0,0,0,0
3500808,2012,0,0,0,0,0,0
3500907,2012,0,0,0,0,0,0
3501004,2012,30,"1,9",21,"1,3",9,"0,6"
3501103,2012,22,"5,4",19,"4,6",3,"0,7"
3501152,2012,0,0,0,0,0,0
3501202,2012,0,0,0,0,0,0
3501301,2012,20,"0,8",18,"0,8",2,"0,1"
3501400,2012,0,0,0,0,0,0
3501509,2012,0,0,0,0,0,0
3501608,2012,686,"3,2",343,"1,6",343,"1,6"
3501707,2012,264,"7,4",264,"7,4",0,0
3501806,2012,0,0,0,0,0,0
3501905,2012,469,7,356,"5,3",113,"1,7"
3502002,2012,0,0,0,0,0,0
3502101,2012,100,"1,8",64,"1,2",36,"0,6"
3502200,2012,57,"2,5",54,"2,4",3,"0,1"
3502309,2012,0,0,0,0,0,0
3502408,2012,0,0,0,0,0,0
3502507,2012,84,"2,4",50,"1,4",34,1
3502606,2012,30,"6,8",8,"1,8",22,5
3502705,2012,47,"1,9",42,"1,7",5,"0,2"
3502754,2012,4,"0,2",0,0,4,"0,2"
3502804,2012,660,"3,6",495,"2,7",165,"0,9"
3502903,2012,90,"3,2",0,0,90,"3,2"
3503000,2012,0,0,0,0,0,0
3503109,2012,16,"2,6",16,"2,6",0,0
3503158,2012,0,0,0,0,0,0
3503208,2012,587,"2,8",278,"1,3",309,"1,5"
3503307,2012,578,"4,8",289,"2,4",289,"2,4"
3503356,2012,0,0,0,0,0,0
3503406,2012,24,3,22,"2,8",2,"0,3"
3503505,2012,0,0,0,0,0,0
3503604,2012,0,0,0,0,0,0
3503703,2012,25,"2,9",4,"0,5",21,"2,4"
3503802,2012,12,"0,3",0,0,12,"0,3"
3503901,2012,82,"1,1",15,"0,2",67,"0,9"
3503950,2012,0,0,0,0,0,0
3504008,2012,389,4,245,"2,5",144,"1,5"
3504107,2012,187,"1,4",48,"0,4",139,"1,1"
3504206,2012,51,"3,6",30,"2,1",21,"1,5"
3504305,2012,0,0,0,0,0,0
3504404,2012,0,0,0,0,0,0
3504503,2012,153,"1,8",95,"1,1",58,"0,7"
3504602,2012,0,0,0,0,0,0
3504701,2012,0,0,0,0,0,0
3504800,2012,0,0,0,0,0,0
3504909,2012,15,"1,5",15,"1,5",0,0
3505005,2012,0,0,0,0,0,0
3505104,2012,0,0,0,0,0,0
3505203,2012,68,"2,1",52,"1,6",16,"0,5"
3505302,2012,101,"2,9",68,"1,9",33,"0,9"
3505351,2012,0,0,0,0,0,0
3505401,2012,0,0,0,0,0,0
3505500,2012,607,"5,4",492,"4,3",115,1
3505609,2012,29,1,29,1,0,0
3505708,2012,477,"1,9",381,"1,6",96,"0,4"
3505807,2012,35,"1,7",28,"1,4",7,"0,3"
3505906,2012,139,"2,4",94,"1,6",45,"0,8"
3506003,2012,1128,"3,2",711,2,417,"1,2"
3506102,2012,155,"2,1",107,"1,4",48,"0,6"
3506201,2012,0,0,0,0,0,0
3506300,2012,50,"4,6",16,"1,5",34,"3,2"
3506359,2012,50,1,50,1,0,0
3506409,2012,35,"4,9",14,"1,9",21,"2,9"
3506508,2012,262,"2,4",170,"1,5",92,"0,8"
3506607,2012,0,0,0,0,0,0
3506706,2012,15,"1,1",13,"0,9",2,"0,1"
3506805,2012,35,"3,1",30,"2,7",5,"0,4"
3506904,2012,0,0,0,0,0,0
3507001,2012,55,"1,1",39,"0,8",16,"0,3"
3507100,2012,11,"0,5",11,"0,5",0,0
3507159,2012,0,0,0,0,0,0
3507209,2012,0,0,0,0,0,0
3507308,2012,0,0,0,0,0,0
3507407,2012,26,"1,8",16,"1,1",10,"0,7"
3507456,2012,0,0,0,0,0,0
3507506,2012,604,"4,6",497,"3,8",107,"0,8"
3507605,2012,331,"2,2",203,"1,4",128,"0,9"
3507704,2012,0,0,0,0,0,0
3507753,2012,0,0,0,0,0,0
3507803,2012,0,0,0,0,0,0
3507902,2012,41,"1,9",35,"1,6",6,"0,3"
3508009,2012,0,0,0,0,0,0
3508108,2012,42,"2,7",22,"1,4",20,"1,3"
3508207,2012,0,0,0,0,0,0
3508306,2012,0,0,0,0,0,0
3508405,2012,36,"0,8",28,"0,6",8,"0,2"
3508504,2012,132,"1,5",63,"0,7",69,"0,8"
3508603,2012,47,"1,5",40,"1,3",7,"0,2"
3508702,2012,65,"3,5",58,"3,1",7,"0,4"
3508801,2012,58,"3,5",47,"2,8",11,"0,7"
3508900,2012,0,0,0,0,0,0
3509007,2012,68,"0,8",29,"0,3",39,"0,4"
3509106,2012,0,0,0,0,0,0
3509205,2012,171,"2,6",71,"1,1",100,"1,5"
3509254,2012,13,"0,5",13,"0,5",0,0
3509304,2012,32,"3,3",26,"2,6",6,"0,6"
3509403,2012,68,"2,9",50,"2,1",18,"0,8"
3509452,2012,0,0,0,0,0,0
3509502,2012,2948,"2,7",1351,"1,2",1597,"1,5"
3509601,2012,56,"0,7",56,"0,7",0,0
3509700,2012,376,"7,8",329,"6,8",47,1
3509809,2012,0,0,0,0,0,0
3509908,2012,0,0,0,0,0,0
3509957,2012,0,0,0,0,0,0
3510005,2012,50,"1,7",40,"1,3",10,"0,3"
3510104,2012,0,0,0,0,0,0
3510153,2012,0,0,0,0,0,0
3510203,2012,67,"1,5",49,"1,1",18,"0,4"
3510302,2012,0,0,0,0,0,0
3510401,2012,119,"2,4",58,"1,2",61,"1,2"
3510500,2012,158,"1,5",120,"1,2",38,"0,4"
3510609,2012,353,"0,9",263,"0,7",90,"0,2"
3510708,2012,31,"2,6",18,"1,5",13,"1,1"
3510807,2012,412,"14,4",395,"13,8",17,"0,6"
3510906,2012,0,0,0,0,0,0
3511003,2012,25,"1,3",21,"1,1",4,"0,2"
3511102,2012,526,"4,6",396,"3,5",130,"1,1"
3511201,2012,0,0,0,0,0,0
3511300,2012,0,0,0,0,0,0
3511409,2012,42,"2,4",33,"1,8",9,"0,5"
3511508,2012,42,1,26,"0,6",16,"0,4"
3511607,2012,30,"1,9",17,"1,1",13,"0,8"
3511706,2012,33,"2,1",26,"1,7",7,"0,5"
3511904,2012,30,"4,1",20,"2,7",10,"1,4"
3512001,2012,47,"2,7",40,"2,3",7,"0,4"
3512100,2012,30,5,20,"3,3",10,"1,7"
3512209,2012,52,2,41,"1,6",11,"0,4"
3512308,2012,42,"2,6",35,"2,1",7,"0,4"
3512407,2012,0,0,0,0,0,0
3512506,2012,0,0,0,0,0,0
3512605,2012,0,0,0,0,0,0
3512704,2012,0,0,0,0,0,0
3512803,2012,103,"1,7",74,"1,2",29,"0,5"
3512902,2012,0,0,0,0,0,0
3513009,2012,287,"1,4",189,"0,9",98,"0,5"
3513108,2012,15,"0,5",13,"0,4",2,"0,1"
3513207,2012,0,0,0,0,0,0
3513306,2012,0,0,0,0,0,0
3513405,2012,152,2,107,"1,4",45,"0,6"
3513504,2012,138,"1,1",134,"1,1",4,0
3513603,2012,40,"1,8",24,"1,1",16,"0,7"
3513702,2012,38,"1,2",23,"0,7",15,"0,5"
3513801,2012,658,"1,7",585,"1,5",73,"0,2"
3513850,2012,0,0,0,0,0,0
3513900,2012,198,"17,8",198,"17,8",0,0
3514007,2012,0,0,0,0,0,0
3514106,2012,65,"2,6",44,"1,7",21,"0,8"
3514205,2012,0,0,0,0,0,0
3514304,2012,18,"2,1",12,"1,4",6,"0,7"
3514403,2012,143,"3,3",108,"2,5",35,"0,8"
3514502,2012,82,"6,7",77,"6,3",5,"0,4"
3514601,2012,0,0,0,0,0,0
3514700,2012,0,0,0,0,0,0
3514809,2012,2,"0,1",2,"0,1",0,0
3514908,2012,6,"0,4",6,"0,4",0,0
3514924,2012,0,0,0,0,0,0
3514957,2012,0,0,0,0,0,0
3515004,2012,77,"0,3",77,"0,3",0,0
3515103,2012,16,"0,3",16,"0,3",0,0
3515129,2012,0,0,0,0,0,0
3515152,2012,0,0,0,0,0,0
3515186,2012,458,"10,9",369,"8,8",89,"2,1"
3515194,2012,0,0,0,0,0,0
3515202,2012,14,"1,7",9,"1,1",5,"0,6"
3515301,2012,0,0,0,0,0,0
3515350,2012,0,0,0,0,0,0
3515400,2012,26,"1,7",17,"1,1",9,"0,6"
3515509,2012,172,"2,6",92,"1,4",80,"1,2"
3515608,2012,0,0,0,0,0,0
3515657,2012,0,0,0,0,0,0
3515707,2012,193,"1,1",193,"1,1",0,0
3515806,2012,0,0,0,0,0,0
3515905,2012,0,0,0,0,0,0
3516002,2012,47,"3,7",30,"2,4",17,"1,3"
3516101,2012,0,0,0,0,0,0
3516200,2012,663,2,424,"1,3",239,"0,7"
3516309,2012,144,"0,9",95,"0,6",49,"0,3"
3516408,2012,654,"4,8",424,"3,1",230,"1,7"
3516507,2012,0,0,0,0,0,0
3516606,2012,45,"6,5",24,"3,5",21,3
3516705,2012,376,"8,7",331,"7,7",45,1
3516804,2012,0,0,0,0,0,0
3516853,2012,0,0,0,0,0,0
3516903,2012,32,3,11,1,21,2
3517000,2012,51,"4,7",42,"3,9",9,"0,8"
3517109,2012,0,0,0,0,0,0
3517208,2012,0,0,0,0,0,0
3517307,2012,0,0,0,0,0,0
3517406,2012,70,"1,9",43,"1,1",27,"0,7"
3517505,2012,0,0,0,0,0,0
3517604,2012,19,"1,1",19,"1,1",0,0
3517703,2012,30,"1,5",22,"1,1",8,"0,4"
3517802,2012,27,"3,2",20,"2,4",7,"0,8"
3517901,2012,0,0,0,0,0,0
3518008,2012,0,0,0,0,0,0
3518107,2012,0,0,0,0,0,0
3518206,2012,74,"2,4",30,1,44,"1,4"
3518305,2012,35,"1,3",28,"1,1",7,"0,3"
3518404,2012,326,"2,9",274,"2,4",52,"0,5"
3518503,2012,0,0,0,0,0,0
3518602,2012,72,2,51,"1,4",21,"0,6"
3518701,2012,276,"0,9",208,"0,7",68,"0,2"
3518800,2012,1922,"1,5",1432,"1,1",490,"0,4"
3518859,2012,0,0,0,0,0,0
3518909,2012,0,0,0,0,0,0
3519006,2012,32,"3,6",19,"2,2",13,"1,5"
3519055,2012,0,0,0,0,0,0
3519071,2012,94,"0,5",65,"0,3",29,"0,1"
3519105,2012,27,"2,6",25,"2,4",2,"0,2"
3519204,2012,15,"2,3",15,"2,3",0,0
3519253,2012,0,0,0,0,0,0
3519303,2012,32,1,32,1,0,0
3519402,2012,27,"2,4",9,"0,8",18,"1,6"
3519501,2012,0,0,0,0,0,0
3519600,2012,93,"1,7",52,1,41,"0,8"
3519709,2012,63,"0,9",63,"0,9",0,0
3519808,2012,0,0,0,0,0,0
3519907,2012,20,"2,6",20,"2,6",0,0
3520004,2012,63,"2,7",55,"2,3",8,"0,3"
3520103,2012,50,"1,8",32,"1,1",18,"0,6"
3520202,2012,15,"1,7",15,"1,7",0,0
3520301,2012,13,"0,4",13,"0,4",0,0
3520400,2012,40,"1,4",37,"1,3",3,"0,1"
3520426,2012,0,0,0,0,0,0
3520442,2012,116,"4,6",74,"2,9",42,"1,7"
3520509,2012,346,"1,6",258,"1,2",88,"0,4"
3520608,2012,0,0,0,0,0,0
3520707,2012,40,"10,3",5,"1,3",35,9
3520806,2012,0,0,0,0,0,0
3520905,2012,49,"3,5",21,"1,5",28,2
3521002,2012,15,"0,5",15,"0,5",0,0
3521101,2012,0,0,0,0,0,0
3521150,2012,0,0,0,0,0,0
3521200,2012,0,0,0,0,0,0
3521309,2012,48,"3,3",28,"1,9",20,"1,4"
3521408,2012,0,0,0,0,0,0
3521507,2012,0,0,0,0,0,0
3521606,2012,0,0,0,0,0,0
3521705,2012,35,2,30,"1,7",5,"0,3"
3521804,2012,41,"1,7",40,"1,6",1,0
3521903,2012,36,"2,5",15,1,21,"1,4"
3522000,2012,0,0,0,0,0,0
3522109,2012,77,"0,9",77,"0,9",0,0
3522158,2012,0,0,0,0,0,0
3522208,2012,472,3,282,"1,8",190,"1,2"
3522307,2012,129,"0,9",93,"0,6",36,"0,2"
3522406,2012,195,"2,2",141,"1,6",54,"0,6"
3522505,2012,254,"1,2",205,1,49,"0,2"
3522604,2012,1377,"19,9",838,"12,1",539,"7,8"
3522653,2012,0,0,0,0,0,0
3522703,2012,73,"1,8",45,"1,1",28,"0,7"
3522802,2012,49,"3,4",33,"2,3",16,"1,1"
3522901,2012,33,"2,6",22,"1,8",11,"0,9"
3523008,2012,0,0,0,0,0,0
3523107,2012,254,"0,8",224,"0,7",30,"0,1"
3523206,2012,97,2,80,"1,7",17,"0,4"
3523305,2012,0,0,0,0,0,0
3523404,2012,112,"1,1",60,"0,6",52,"0,5"
3523503,2012,14,"0,8",7,"0,4",7,"0,4"
3523602,2012,24,"1,5",20,"1,3",4,"0,3"
3523701,2012,0,0,0,0,0,0
3523800,2012,0,0,0,0,0,0
3523909,2012,426,"2,7",391,"2,5",35,"0,2"
3524006,2012,86,"1,8",48,1,38,"0,8"
3524105,2012,120,"3,1",58,"1,5",62,"1,6"
3524204,2012,17,"2,6",17,"2,6",0,0
3524303,2012,136,"1,9",66,"0,9",70,1
3524402,2012,383,"1,8",205,1,178,"0,8"
3524501,2012,177,"29,9",135,"22,8",42,"7,1"
3524600,2012,0,0,0,0,0,0
3524709,2012,75,"1,6",75,"1,6",0,0
3524808,2012,144,"3,1",70,"1,5",74,"1,6"
3524907,2012,0,0,0,0,0,0
3525003,2012,58,"0,5",44,"0,4",14,"0,1"
3525102,2012,0,0,0,0,0,0
3525201,2012,33,"1,3",12,"0,5",21,"0,8"
3525300,2012,919,"6,8",733,"5,5",186,"1,4"
3525409,2012,0,0,0,0,0,0
3525508,2012,24,2,17,"1,4",7,"0,6"
3525607,2012,0,0,0,0,0,0
3525706,2012,61,"1,8",34,1,27,"0,8"
3525805,2012,0,0,0,0,0,0
3525854,2012,0,0,0,0,0,0
3525904,2012,641,"1,7",282,"0,7",359,"0,9"
3526001,2012,52,"2,7",26,"1,4",26,"1,4"
3526100,2012,15,"0,8",15,"0,8",0,0
3526209,2012,24,"0,8",24,"0,8",0,0
3526308,2012,0,0,0,0,0,0
3526407,2012,47,"1,8",33,"1,3",14,"0,5"
3526506,2012,0,0,0,0,0,0
3526605,2012,0,0,0,0,0,0
3526704,2012,127,"1,4",76,"0,8",51,"0,5"
3526803,2012,80,"1,3",57,"0,9",23,"0,4"
3526902,2012,431,"1,5",237,"0,8",194,"0,7"
3527009,2012,0,0,0,0,0,0
3527108,2012,484,"6,7",379,"5,2",105,"1,5"
3527207,2012,173,"2,1",105,"1,3",68,"0,8"
3527256,2012,0,0,0,0,0,0
3527306,2012,41,1,34,"0,9",7,"0,2"
3527405,2012,67,"3,3",48,"2,4",19,"0,9"
3527504,2012,0,0,0,0,0,0
3527603,2012,0,0,0,0,0,0
3527702,2012,32,"6,2",15,"2,9",17,"3,3"
3527801,2012,0,0,0,0,0,0
3527900,2012,0,0,0,0,0,0
3528007,2012,31,"1,9",18,"1,1",13,"0,8"
3528106,2012,24,"3,1",5,"0,7",19,"2,5"
3528205,2012,0,0,0,0,0,0
3528304,2012,0,0,0,0,0,0
3528403,2012,0,0,0,0,0,0
3528502,2012,47,"0,6",47,"0,6",0,0
3528601,2012,0,0,0,0,0,0
3528700,2012,0,0,0,0,0,0
3528809,2012,26,"1,9",22,"1,6",4,"0,3"
3528858,2012,0,0,0,0,0,0
3528908,2012,0,0,0,0,0,0
3529005,2012,887,4,728,"3,3",159,"0,7"
3529104,2012,0,0,0,0,0,0
3529203,2012,66,"2,7",41,"1,7",25,1
3529302,2012,164,"2,1",96,"1,2",68,"0,9"
3529401,2012,512,"1,2",236,"0,6",276,"0,6"
3529500,2012,0,0,0,0,0,0
3529609,2012,0,0,0,0,0,0
3529658,2012,0,0,0,0,0,0
3529708,2012,66,"3,2",47,"2,3",19,"0,9"
3529807,2012,0,0,0,0,0,0
3529906,2012,16,"0,8",16,"0,8",0,0
3530003,2012,0,0,0,0,0,0
3530102,2012,126,"4,5",96,"3,5",30,"1,1"
3530201,2012,0,0,0,0,0,0
3530300,2012,93,"1,7",24,"0,4",69,"1,3"
3530409,2012,0,0,0,0,0,0
3530508,2012,140,"2,1",98,"1,5",42,"0,6"
3530607,2012,736,"1,9",561,"1,4",175,"0,4"
3530706,2012,329,"2,4",149,"1,1",180,"1,3"
3530805,2012,264,3,140,"1,6",124,"1,4"
3530904,2012,0,0,0,0,0,0
3531001,2012,0,0,0,0,0,0
3531100,2012,44,"0,9",44,"0,9",0,0
3531209,2012,0,0,0,0,0,0
3531308,2012,109,"2,3",58,"1,2",51,"1,1"
3531407,2012,80,"3,6",35,"1,6",45,2
3531506,2012,70,"3,7",49,"2,6",21,"1,1"
3531605,2012,0,0,0,0,0,0
3531704,2012,0,0,0,0,0,0
3531803,2012,45,"0,9",38,"0,7",7,"0,1"
3531902,2012,45,"1,5",31,1,14,"0,5"
3532009,2012,42,"3,5",13,"1,1",29,"2,4"
3532058,2012,0,0,0,0,0,0
3532108,2012,22,"5,2",22,"5,2",0,0
3532157,2012,0,0,0,0,0,0
3532207,2012,0,0,0,0,0,0
3532306,2012,0,0,0,0,0,0
3532405,2012,24,"1,4",24,"1,4",0,0
3532504,2012,34,"3,9",11,"1,3",23,"2,6"
3532603,2012,124,"11,5",36,"3,3",88,"8,2"
3532702,2012,0,0,0,0,0,0
3532801,2012,0,0,0,0,0,0
3532827,2012,0,0,0,0,0,0
3532843,2012,0,0,0,0,0,0
3532868,2012,0,0,0,0,0,0
3532900,2012,12,"1,3",7,"0,7",5,"0,5"
3533007,2012,193,"9,9",42,"2,2",151,"7,7"
3533106,2012,0,0,0,0,0,0
3533205,2012,0,0,0,0,0,0
3533254,2012,0,0,0,0,0,0
3533304,2012,0,0,0,0,0,0
3533403,2012,53,1,53,1,0,0
3533502,2012,105,"2,8",38,1,67,"1,8"
3533601,2012,0,0,0,0,0,0
3533700,2012,0,0,0,0,0,0
3533809,2012,0,0,0,0,0,0
3533908,2012,94,"1,9",76,"1,5",18,"0,4"
3534005,2012,0,0,0,0,0,0
3534104,2012,0,0,0,0,0,0
3534203,2012,0,0,0,0,0,0
3534302,2012,118,"2,9",72,"1,8",46,"1,1"
3534401,2012,909,"1,4",599,"0,9",310,"0,5"
3534500,2012,0,0,0,0,0,0
3534609,2012,118,"3,8",71,"2,3",47,"1,5"
3534708,2012,315,3,230,"2,2",85,"0,8"
3534757,2012,39,"4,5",10,"1,2",29,"3,3"
3534807,2012,0,0,0,0,0,0
3534906,2012,32,"2,4",29,"2,2",3,"0,2"
3535002,2012,0,0,0,0,0,0
3535101,2012,0,0,0,0,0,0
3535200,2012,24,"2,5",10,"1,1",14,"1,5"
3535309,2012,68,"3,2",44,"2,1",24,"1,1"
3535408,2012,65,"4,4",45,"3,1",20,"1,4"
3535507,2012,97,"2,3",78,"1,8",19,"0,4"
3535606,2012,14,"0,8",12,"0,7",2,"0,1"
3535705,2012,0,0,0,0,0,0
3535804,2012,30,"1,6",30,"1,6",0,0
3535903,2012,0,0,0,0,0,0
3536000,2012,32,3,26,"2,4",6,"0,6"
3536109,2012,0,0,0,0,0,0
3536208,2012,152,"8,2",152,"8,2",0,0
3536257,2012,0,0,0,0,0,0
3536307,2012,35,"2,6",23,"1,7",12,"0,9"
3536406,2012,0,0,0,0,0,0
3536505,2012,84,1,84,1,0,0
3536570,2012,0,0,0,0,0,0
3536604,2012,24,"2,8",9,"1,1",15,"1,8"
3536703,2012,72,"1,7",52,"1,2",20,"0,5"
3536802,2012,0,0,0,0,0,0
3536901,2012,0,0,0,0,0,0
3537008,2012,53,"3,4",33,"2,1",20,"1,3"
3537107,2012,49,"1,2",39,"0,9",10,"0,2"
3537156,2012,0,0,0,0,0,0
3537206,2012,0,0,0,0,0,0
3537305,2012,238,4,168,"2,8",70,"1,2"
3537404,2012,98,"3,9",65,"2,6",33,"1,3"
3537503,2012,0,0,0,0,0,0
3537602,2012,39,"0,6",39,"0,6",0,0
3537701,2012,0,0,0,0,0,0
3537800,2012,515,"9,8",471,9,44,"0,8"
3537909,2012,35,"1,3",27,1,8,"0,3"
3538006,2012,170,"1,1",117,"0,8",53,"0,4"
3538105,2012,0,0,0,0,0,0
3538204,2012,0,0,0,0,0,0
3538303,2012,0,0,0,0,0,0
3538501,2012,0,0,0,0,0,0
3538600,2012,37,"1,5",29,"1,1",8,"0,3"
3538709,2012,807,"2,2",316,"0,9",491,"1,3"
3538808,2012,80,"2,8",71,"2,5",9,"0,3"
3538907,2012,303,"13,3",293,"12,8",10,"0,4"
3539004,2012,37,"3,5",9,"0,8",28,"2,6"
3539103,2012,0,0,0,0,0,0
3539202,2012,59,"2,3",59,"2,3",0,0
3539301,2012,87,"1,2",52,"0,7",35,"0,5"
3539400,2012,30,"2,4",26,"2,1",4,"0,3"
3539509,2012,50,"1,4",32,"0,9",18,"0,5"
3539608,2012,0,0,0,0,0,0
3539707,2012,0,0,0,0,0,0
3539806,2012,21,"0,2",21,"0,2",0,0
3539905,2012,0,0,0,0,0,0
3540002,2012,41,2,41,2,0,0
3540101,2012,0,0,0,0,0,0
3540200,2012,75,"1,8",45,"1,1",30,"0,7"
3540259,2012,0,0,0,0,0,0
3540309,2012,0,0,0,0,0,0
3540408,2012,18,"4,3",8,"1,9",10,"2,4"
3540507,2012,0,0,0,0,0,0
3540606,2012,45,"0,9",35,"0,7",10,"0,2"
3540705,2012,61,"1,2",37,"0,7",24,"0,5"
3540754,2012,0,0,0,0,0,0
3540804,2012,28,"1,8",20,"1,3",8,"0,5"
3540853,2012,0,0,0,0,0,0
3540903,2012,0,0,0,0,0,0
3541000,2012,199,"0,7",113,"0,4",86,"0,3"
3541059,2012,0,0,0,0,0,0
3541109,2012,0,0,0,0,0,0
3541208,2012,51,"3,7",40,"2,9",11,"0,8"
3541307,2012,78,"1,9",68,"1,6",10,"0,2"
3541406,2012,1608,"7,6",1094,"5,2",514,"2,4"
3541505,2012,97,"2,6",75,2,22,"0,6"
3541604,2012,78,"2,1",78,"2,1",0,0
3541653,2012,0,0,0,0,0,0
3541703,2012,0,0,0,0,0,0
3541802,2012,0,0,0,0,0,0
3541901,2012,26,"2,2",26,"2,2",0,0
3542008,2012,0,0,0,0,0,0
3542107,2012,0,0,0,0,0,0
3542206,2012,98,"3,4",70,"2,4",28,1
3542305,2012,0,0,0,0,0,0
3542404,2012,24,"1,3",17,"0,9",7,"0,4"
3542503,2012,0,0,0,0,0,0
3542602,2012,105,"1,9",63,"1,2",42,"0,8"
3542701,2012,0,0,0,0,0,0
3542800,2012,0,0,0,0,0,0
3542909,2012,17,"1,4",9,"0,7",8,"0,7"
3543006,2012,36,2,35,"1,9",1,"0,1"
3543105,2012,0,0,0,0,0,0
3543204,2012,0,0,0,0,0,0
3543238,2012,0,0,0,0,0,0
3543253,2012,0,0,0,0,0,0
3543303,2012,164,"1,4",50,"0,4",114,1
3543402,2012,1918,"3,1",1374,"2,2",544,"0,9"
3543501,2012,0,0,0,0,0,0
3543600,2012,0,0,0,0,0,0
3543709,2012,0,0,0,0,0,0
3543808,2012,33,"3,3",20,2,13,"1,3"
3543907,2012,510,"2,7",274,"1,4",236,"1,2"
3544004,2012,53,"1,7",38,"1,2",15,"0,5"
3544103,2012,0,0,0,0,0,0
3544202,2012,36,"3,4",7,"0,7",29,"2,7"
3544251,2012,57,"2,9",57,"2,9",0,0
3544301,2012,14,"1,4",14,"1,4",0,0
3544400,2012,0,0,0,0,0,0
3544509,2012,0,0,0,0,0,0
3544608,2012,0,0,0,0,0,0
3544707,2012,0,0,0,0,0,0
3544806,2012,0,0,0,0,0,0
3544905,2012,29,"2,7",19,"1,8",10,"0,9"
3545001,2012,24,"1,5",21,"1,3",3,"0,2"
3545100,2012,0,0,0,0,0,0
3545159,2012,0,0,0,0,0,0
3545209,2012,123,"1,1",70,"0,7",53,"0,5"
3545308,2012,1018,"24,9",992,"24,2",26,"0,6"
3545407,2012,34,"3,8",17,"1,9",17,"1,9"
3545506,2012,0,0,0,0,0,0
3545605,2012,31,"2,1",11,"0,8",20,"1,4"
3545704,2012,0,0,0,0,0,0
3545803,2012,136,"0,7",105,"0,6",31,"0,2"
3546009,2012,0,0,0,0,0,0
3546108,2012,0,0,0,0,0,0
3546207,2012,0,0,0,0,0,0
3546256,2012,0,0,0,0,0,0
3546306,2012,43,"1,4",22,"0,7",21,"0,7"
3546405,2012,102,"2,3",59,"1,3",43,1
3546504,2012,0,0,0,0,0,0
3546603,2012,76,"2,6",33,"1,1",43,"1,5"
3546702,2012,0,0,0,0,0,0
3546801,2012,102,2,90,"1,8",12,"0,2"
3546900,2012,0,0,0,0,0,0
3547007,2012,5,"0,9",5,"0,9",0,0
3547106,2012,0,0,0,0,0,0
3547205,2012,0,0,0,0,0,0
3547304,2012,20,"0,2",20,"0,2",0,0
3547403,2012,0,0,0,0,0,0
3547502,2012,299,"11,3",271,"10,2",28,"1,1"
3547601,2012,30,"1,2",18,"0,7",12,"0,5"
3547650,2012,0,0,0,0,0,0
3547700,2012,56,"2,7",37,"1,8",19,"0,9"
3547809,2012,1501,"2,2",669,1,832,"1,2"
3547908,2012,12,"1,9",12,"1,9",0,0
3548005,2012,0,0,0,0,0,0
3548054,2012,0,0,0,0,0,0
3548104,2012,0,0,0,0,0,0
3548203,2012,0,0,0,0,0,0
3548302,2012,0,0,0,0,0,0
3548401,2012,0,0,0,0,0,0
3548500,2012,1643,"3,9",737,"1,8",906,"2,2"
3548609,2012,40,"3,8",24,"2,3",16,"1,5"
3548708,2012,1474,"1,9",759,1,715,"0,9"
3548807,2012,541,"3,6",163,"1,1",378,"2,5"
3548906,2012,419,"1,9",204,"0,9",215,1
3549003,2012,0,0,0,0,0,0
3549102,2012,190,"2,3",84,1,106,"1,3"
3549201,2012,0,0,0,0,0,0
3549250,2012,0,0,0,0,0,0
3549300,2012,0,0,0,0,0,0
3549409,2012,115,"2,4",68,"1,4",47,1
3549508,2012,0,0,0,0,0,0
3549607,2012,0,0,0,0,0,0
3549706,2012,145,"2,8",89,"1,7",56,"1,1"
3549805,2012,1695,"4,1",992,"2,4",703,"1,7"
3549904,2012,1457,"2,3",832,"1,3",625,1
3549953,2012,0,0,0,0,0,0
3550001,2012,26,"2,5",11,"1,1",15,"1,4"
3550100,2012,36,"0,9",22,"0,6",14,"0,4"
3550209,2012,6,"0,2",6,"0,2",0,0
3550308,2012,28669,"2,5",15084,"1,3",13585,"1,2"
3550407,2012,62,"1,9",37,"1,1",25,"0,8"
3550506,2012,0,0,0,0,0,0
3550605,2012,103,"1,3",54,"0,7",49,"0,6"
3550704,2012,101,"1,3",93,"1,2",8,"0,1"
3550803,2012,30,"2,5",26,"2,2",4,"0,3"
3550902,2012,40,"2,8",32,"2,2",8,"0,6"
3551009,2012,220,"0,7",165,"0,5",55,"0,2"
3551108,2012,0,0,0,0,0,0
3551207,2012,0,0,0,0,0,0
3551306,2012,0,0,0,0,0,0
3551405,2012,0,0,0,0,0,0
3551504,2012,58,"1,5",43,"1,1",15,"0,4"
3551603,2012,55,"2,1",42,"1,6",13,"0,5"
3551702,2012,155,"1,4",75,"0,7",80,"0,7"
3551801,2012,0,0,0,0,0,0
3551900,2012,0,0,0,0,0,0
3552007,2012,3,"0,5",3,"0,5",0,0
3552106,2012,62,"1,7",54,"1,5",8,"0,2"
3552205,2012,2590,"4,3",2159,"3,6",431,"0,7"
3552304,2012,20,"2,7",20,"2,7",0,0
3552403,2012,184,"0,7",180,"0,7",4,0
3552502,2012,187,"0,7",106,"0,4",81,"0,3"
3552551,2012,0,0,0,0,0,0
3552601,2012,30,"2,6",11,1,19,"1,7"
3552700,2012,35,"2,3",22,"1,5",13,"0,9"
3552809,2012,563,"2,2",332,"1,3",231,"0,9"
3552908,2012,0,0,0,0,0,0
3553005,2012,17,"1,5",12,"1,1",5,"0,4"
3553104,2012,0,0,0,0,0,0
3553203,2012,4,"0,7",4,"0,7",0,0
3553302,2012,36,"1,6",23,1,13,"0,6"
3553401,2012,72,3,38,"1,6",34,"1,4"
3553500,2012,0,0,0,0,0,0
3553609,2012,34,"2,7",21,"1,7",13,1
3553658,2012,0,0,0,0,0,0
3553708,2012,116,"2,1",69,"1,3",47,"0,9"
3553807,2012,55,"2,4",36,"1,6",19,"0,8"
3553856,2012,0,0,0,0,0,0
3553906,2012,0,0,0,0,0,0
3553955,2012,0,0,0,0,0,0
3554003,2012,159,"1,4",100,"0,9",59,"0,5"
3554102,2012,486,"1,7",319,"1,1",167,"0,6"
3554201,2012,0,0,0,0,0,0
3554300,2012,58,"2,7",52,"2,4",6,"0,3"
3554409,2012,34,"3,9",30,"3,5",4,"0,5"
3554508,2012,60,"1,6",35,"0,9",25,"0,7"
3554607,2012,0,0,0,0,0,0
3554656,2012,0,0,0,0,0,0
3554706,2012,20,"2,1",13,"1,4",7,"0,7"
3554755,2012,0,0,0,0,0,0
3554805,2012,30,"0,7",19,"0,5",11,"0,3"
3554904,2012,0,0,0,0,0,0
3554953,2012,0,0,0,0,0,0
3555000,2012,864,"13,6",791,"12,5",73,"1,2"
3555109,2012,48,"3,3",30,"2,1",18,"1,2"
3555208,2012,0,0,0,0,0,0
3555307,2012,0,0,0,0,0,0
3555356,2012,0,0,0,0,0,0
3555406,2012,92,"1,1",68,"0,8",24,"0,3"
3555505,2012,0,0,0,0,0,0
3555604,2012,0,0,0,0,0,0
3555703,2012,0,0,0,0,0,0
3555802,2012,38,"4,3",9,1,29,"3,3"
3555901,2012,0,0,0,0,0,0
3556008,2012,34,"2,7",15,"1,2",19,"1,5"
3556107,2012,0,0,0,0,0,0
3556206,2012,165,"1,5",65,"0,6",100,"0,9"
3556305,2012,55,"2,4",31,"1,4",24,"1,1"
3556354,2012,0,0,0,0,0,0
3556404,2012,88,"2,2",53,"1,3",35,"0,9"
3556453,2012,0,0,0,0,0,0
3556503,2012,36,"0,3",36,"0,3",0,0
3556602,2012,0,0,0,0,0,0
3556701,2012,95,"1,4",59,"0,9",36,"0,5"
3556800,2012,54,"3,1",20,"1,1",34,"1,9"
3556909,2012,9,"1,3",9,"1,3",0,0
3556958,2012,0,0,0,0,0,0
3557006,2012,146,"1,3",84,"0,8",62,"0,6"
3557105,2012,240,"2,8",118,"1,4",122,"1,4"
3557154,2012,0,0,0,0,0,0
3557204,2012,48,4,20,"1,6",28,"2,3"
3557303,2012,0,0,0,0,0,0
3500105,2013,284,"8,4",240,"7,1",44,"1,3"
3500204,2013,0,0,0,0,0,0
3500303,2013,0,0,0,0,0,0
3500402,2013,0,0,0,0,0,0
3500501,2013,42,"2,4",30,"1,7",12,"0,7"
3500550,2013,0,0,0,0,0,0
3500600,2013,4,"1,4",4,"1,4",0,0
3500709,2013,65,"1,9",43,"1,2",22,"0,6"
3500758,2013,0,0,0,0,0,0
3500808,2013,0,0,0,0,0,0
3500907,2013,0,0,0,0,0,0
3501004,2013,31,2,25,"1,6",6,"0,4"
3501103,2013,22,"5,4",19,"4,7",3,"0,7"
3501152,2013,0,0,0,0,0,0
3501202,2013,0,0,0,0,0,0
3501301,2013,20,"0,8",18,"0,8",2,"0,1"
3501400,2013,0,0,0,0,0,0
3501509,2013,0,0,0,0,0,0
3501608,2013,683,"3,1",340,"1,6",343,"1,6"
3501707,2013,204,"5,6",204,"5,6",0,0
3501806,2013,0,0,0,0,0,0
3501905,2013,349,"5,2",236,"3,5",113,"1,7"
3502002,2013,0,0,0,0,0,0
3502101,2013,135,"2,4",110,2,25,"0,4"
3502200,2013,57,"2,5",54,"2,4",3,"0,1"
3502309,2013,0,0,0,0,0,0
3502408,2013,0,0,0,0,0,0
3502507,2013,84,"2,4",50,"1,4",34,1
3502606,2013,30,"6,9",8,"1,8",22,"5,1"
3502705,2013,51,2,45,"1,8",6,"0,2"
3502754,2013,4,"0,2",0,0,4,"0,2"
3502804,2013,625,"3,4",477,"2,6",148,"0,8"
3502903,2013,90,"3,1",0,0,90,"3,1"
3503000,2013,0,0,0,0,0,0
3503109,2013,16,"2,6",16,"2,6",0,0
3503158,2013,0,0,0,0,0,0
3503208,2013,586,"2,7",268,"1,2",318,"1,5"
3503307,2013,557,"4,5",289,"2,4",268,"2,2"
3503356,2013,0,0,0,0,0,0
3503406,2013,28,"3,5",17,"2,1",11,"1,4"
3503505,2013,0,0,0,0,0,0
3503604,2013,0,0,0,0,0,0
3503703,2013,25,"2,8",4,"0,5",21,"2,4"
3503802,2013,12,"0,3",0,0,12,"0,3"
3503901,2013,82,1,15,"0,2",67,"0,8"
3503950,2013,0,0,0,0,0,0
3504008,2013,311,"3,2",199,"2,1",112,"1,2"
3504107,2013,187,"1,4",50,"0,4",137,1
3504206,2013,51,"3,6",30,"2,1",21,"1,5"
3504305,2013,0,0,0,0,0,0
3504404,2013,0,0,0,0,0,0
3504503,2013,153,"1,8",95,"1,1",58,"0,7"
3504602,2013,0,0,0,0,0,0
3504701,2013,0,0,0,0,0,0
3504800,2013,0,0,0,0,0,0
3504909,2013,15,"1,5",15,"1,5",0,0
3505005,2013,0,0,0,0,0,0
3505104,2013,0,0,0,0,0,0
3505203,2013,68,"2,1",52,"1,6",16,"0,5"
3505302,2013,101,"2,9",68,"1,9",33,"0,9"
3505351,2013,0,0,0,0,0,0
3505401,2013,0,0,0,0,0,0
3505500,2013,642,"5,6",527,"4,6",115,1
3505609,2013,29,1,29,1,0,0
3505708,2013,477,"1,9",381,"1,5",96,"0,4"
3505807,2013,35,"1,7",28,"1,4",7,"0,3"
3505906,2013,139,"2,4",94,"1,6",45,"0,8"
3506003,2013,1144,"3,3",697,2,447,"1,3"
3506102,2013,157,"2,1",111,"1,5",46,"0,6"
3506201,2013,0,0,0,0,0,0
3506300,2013,50,"4,6",20,"1,9",30,"2,8"
3506359,2013,46,"0,9",46,"0,9",0,0
3506409,2013,36,"4,9",36,"4,9",0,0
3506508,2013,242,"2,1",155,"1,4",87,"0,8"
3506607,2013,0,0,0,0,0,0
3506706,2013,15,"1,1",13,"0,9",2,"0,1"
3506805,2013,35,"3,1",30,"2,7",5,"0,4"
3506904,2013,0,0,0,0,0,0
3507001,2013,55,"1,1",39,"0,8",16,"0,3"
3507100,2013,11,"0,5",11,"0,5",0,0
3507159,2013,0,0,0,0,0,0
3507209,2013,0,0,0,0,0,0
3507308,2013,0,0,0,0,0,0
3507407,2013,26,"1,8",16,"1,1",10,"0,7"
3507456,2013,0,0,0,0,0,0
3507506,2013,604,"4,6",497,"3,8",107,"0,8"
3507605,2013,343,"2,3",215,"1,4",128,"0,8"
3507704,2013,0,0,0,0,0,0
3507753,2013,0,0,0,0,0,0
3507803,2013,0,0,0,0,0,0
3507902,2013,41,"1,8",35,"1,6",6,"0,3"
3508009,2013,0,0,0,0,0,0
3508108,2013,42,"2,7",22,"1,4",20,"1,3"
3508207,2013,0,0,0,0,0,0
3508306,2013,0,0,0,0,0,0
3508405,2013,36,"0,8",28,"0,6",8,"0,2"
3508504,2013,147,"1,7",74,"0,9",73,"0,8"
3508603,2013,47,"1,5",40,"1,3",7,"0,2"
3508702,2013,61,"3,3",55,3,6,"0,3"
3508801,2013,58,"3,5",47,"2,8",11,"0,7"
3508900,2013,0,0,0,0,0,0
3509007,2013,68,"0,7",29,"0,3",39,"0,4"
3509106,2013,0,0,0,0,0,0
3509205,2013,171,"2,5",71,1,100,"1,5"
3509254,2013,13,"0,5",13,"0,5",0,0
3509304,2013,32,"3,2",26,"2,6",6,"0,6"
3509403,2013,68,"2,8",50,"2,1",18,"0,7"
3509452,2013,0,0,0,0,0,0
3509502,2013,2961,"2,7",1425,"1,3",1536,"1,4"
3509601,2013,56,"0,7",56,"0,7",0,0
3509700,2013,376,"7,8",329,"6,8",47,1
3509809,2013,0,0,0,0,0,0
3509908,2013,0,0,0,0,0,0
3509957,2013,0,0,0,0,0,0
3510005,2013,50,"1,7",40,"1,3",10,"0,3"
3510104,2013,0,0,0,0,0,0
3510153,2013,0,0,0,0,0,0
3510203,2013,67,"1,5",49,"1,1",18,"0,4"
3510302,2013,0,0,0,0,0,0
3510401,2013,96,"1,9",41,"0,8",55,"1,1"
3510500,2013,158,"1,5",120,"1,1",38,"0,4"
3510609,2013,353,"0,9",263,"0,7",90,"0,2"
3510708,2013,31,"2,6",18,"1,5",13,"1,1"
3510807,2013,412,"14,4",395,"13,8",17,"0,6"
3510906,2013,0,0,0,0,0,0
3511003,2013,31,"1,6",27,"1,4",4,"0,2"
3511102,2013,513,"4,5",373,"3,3",140,"1,2"
3511201,2013,0,0,0,0,0,0
3511300,2013,0,0,0,0,0,0
3511409,2013,42,"2,3",33,"1,8",9,"0,5"
3511508,2013,43,1,33,"0,8",10,"0,2"
3511607,2013,30,"1,9",17,"1,1",13,"0,8"
3511706,2013,33,"2,1",26,"1,7",7,"0,4"
3511904,2013,30,4,20,"2,7",10,"1,3"
3512001,2013,47,"2,7",40,"2,3",7,"0,4"
3512100,2013,30,5,20,"3,3",10,"1,7"
3512209,2013,52,2,41,"1,6",11,"0,4"
3512308,2013,42,"2,5",42,"2,5",0,0
3512407,2013,0,0,0,0,0,0
3512506,2013,0,0,0,0,0,0
3512605,2013,0,0,0,0,0,0
3512704,2013,0,0,0,0,0,0
3512803,2013,103,"1,6",74,"1,2",29,"0,5"
3512902,2013,0,0,0,0,0,0
3513009,2013,287,"1,3",189,"0,9",98,"0,5"
3513108,2013,15,"0,5",13,"0,4",2,"0,1"
3513207,2013,0,0,0,0,0,0
3513306,2013,0,0,0,0,0,0
3513405,2013,156,2,111,"1,4",45,"0,6"
3513504,2013,138,"1,1",134,"1,1",4,0
3513603,2013,40,"1,8",25,"1,1",15,"0,7"
3513702,2013,38,"1,2",23,"0,7",15,"0,5"
3513801,2013,720,"1,8",574,"1,5",146,"0,4"
3513850,2013,0,0,0,0,0,0
3513900,2013,198,"17,8",198,"17,8",0,0
3514007,2013,0,0,0,0,0,0
3514106,2013,67,"2,6",47,"1,8",20,"0,8"
3514205,2013,0,0,0,0,0,0
3514304,2013,18,"2,1",12,"1,4",6,"0,7"
3514403,2013,143,"3,3",108,"2,5",35,"0,8"
3514502,2013,82,"6,7",77,"6,3",5,"0,4"
3514601,2013,0,0,0,0,0,0
3514700,2013,0,0,0,0,0,0
3514809,2013,2,"0,1",2,"0,1",0,0
3514908,2013,6,"0,4",6,"0,4",0,0
3514924,2013,0,0,0,0,0,0
3514957,2013,0,0,0,0,0,0
3515004,2013,71,"0,3",71,"0,3",0,0
3515103,2013,16,"0,2",16,"0,2",0,0
3515129,2013,0,0,0,0,0,0
3515152,2013,0,0,0,0,0,0
3515186,2013,458,"10,9",369,"8,8",89,"2,1"
3515194,2013,0,0,0,0,0,0
3515202,2013,50,"6,1",30,"3,7",20,"2,4"
3515301,2013,0,0,0,0,0,0
3515350,2013,0,0,0,0,0,0
3515400,2013,26,"1,7",17,"1,1",9,"0,6"
3515509,2013,172,"2,6",92,"1,4",80,"1,2"
3515608,2013,0,0,0,0,0,0
3515657,2013,0,0,0,0,0,0
3515707,2013,193,"1,1",193,"1,1",0,0
3515806,2013,0,0,0,0,0,0
3515905,2013,0,0,0,0,0,0
3516002,2013,47,"3,7",30,"2,4",17,"1,3"
3516101,2013,0,0,0,0,0,0
3516200,2013,720,"2,2",456,"1,4",264,"0,8"
3516309,2013,144,"0,9",95,"0,6",49,"0,3"
3516408,2013,654,"4,7",424,"3,1",230,"1,7"
3516507,2013,0,0,0,0,0,0
3516606,2013,45,"6,6",24,"3,5",21,"3,1"
3516705,2013,376,"8,8",331,"7,7",45,1
3516804,2013,0,0,0,0,0,0
3516853,2013,0,0,0,0,0,0
3516903,2013,32,3,11,1,21,2
3517000,2013,51,"4,7",42,"3,9",9,"0,8"
3517109,2013,0,0,0,0,0,0
3517208,2013,0,0,0,0,0,0
3517307,2013,0,0,0,0,0,0
3517406,2013,60,"1,6",42,"1,1",18,"0,5"
3517505,2013,0,0,0,0,0,0
3517604,2013,19,"1,1",19,"1,1",0,0
3517703,2013,30,"1,5",22,"1,1",8,"0,4"
3517802,2013,27,"3,2",20,"2,4",7,"0,8"
3517901,2013,0,0,0,0,0,0
3518008,2013,0,0,0,0,0,0
3518107,2013,0,0,0,0,0,0
3518206,2013,74,"2,4",30,1,44,"1,4"
3518305,2013,35,"1,3",28,1,7,"0,3"
3518404,2013,303,"2,7",210,"1,8",93,"0,8"
3518503,2013,0,0,0,0,0,0
3518602,2013,72,2,50,"1,4",22,"0,6"
3518701,2013,305,1,237,"0,8",68,"0,2"
3518800,2013,1928,"1,5",1441,"1,1",487,"0,4"
3518859,2013,0,0,0,0,0,0
3518909,2013,0,0,0,0,0,0
3519006,2013,32,"3,6",32,"3,6",0,0
3519055,2013,0,0,0,0,0,0
3519071,2013,91,"0,4",62,"0,3",29,"0,1"
3519105,2013,27,"2,6",25,"2,4",2,"0,2"
3519204,2013,19,3,15,"2,4",4,"0,6"
3519253,2013,0,0,0,0,0,0
3519303,2013,32,1,32,1,0,0
3519402,2013,27,"2,4",9,"0,8",18,"1,6"
3519501,2013,0,0,0,0,0,0
3519600,2013,99,"1,8",52,"0,9",47,"0,9"
3519709,2013,67,"0,9",63,"0,9",4,"0,1"
3519808,2013,0,0,0,0,0,0
3519907,2013,20,"2,6",20,"2,6",0,0
3520004,2013,63,"2,7",55,"2,3",8,"0,3"
3520103,2013,50,"1,8",32,"1,1",18,"0,6"
3520202,2013,15,"1,7",15,"1,7",0,0
3520301,2013,13,"0,4",13,"0,4",0,0
3520400,2013,40,"1,3",37,"1,2",3,"0,1"
3520426,2013,0,0,0,0,0,0
3520442,2013,116,"4,6",74,"2,9",42,"1,7"
3520509,2013,367,"1,7",258,"1,2",109,"0,5"
3520608,2013,0,0,0,0,0,0
3520707,2013,40,"10,3",5,"1,3",35,9
3520806,2013,0,0,0,0,0,0
3520905,2013,49,"3,5",29,"2,1",20,"1,4"
3521002,2013,15,"0,5",15,"0,5",0,0
3521101,2013,0,0,0,0,0,0
3521150,2013,0,0,0,0,0,0
3521200,2013,0,0,0,0,0,0
3521309,2013,49,"3,3",40,"2,7",9,"0,6"
3521408,2013,0,0,0,0,0,0
3521507,2013,0,0,0,0,0,0
3521606,2013,0,0,0,0,0,0
3521705,2013,35,2,30,"1,7",5,"0,3"
3521804,2013,41,"1,7",40,"1,6",1,0
3521903,2013,30,"2,1",13,"0,9",17,"1,2"
3522000,2013,0,0,0,0,0,0
3522109,2013,74,"0,8",74,"0,8",0,0
3522158,2013,0,0,0,0,0,0
3522208,2013,446,"2,8",281,"1,8",165,1
3522307,2013,129,"0,9",107,"0,7",22,"0,1"
3522406,2013,192,"2,2",150,"1,7",42,"0,5"
3522505,2013,254,"1,2",205,1,49,"0,2"
3522604,2013,1377,"19,8",838,12,539,"7,7"
3522653,2013,0,0,0,0,0,0
3522703,2013,76,"1,9",45,"1,1",31,"0,8"
3522802,2013,49,"3,4",33,"2,3",16,"1,1"
3522901,2013,33,"2,6",22,"1,7",11,"0,9"
3523008,2013,0,0,0,0,0,0
3523107,2013,224,"0,7",224,"0,7",0,0
3523206,2013,98,2,82,"1,7",16,"0,3"
3523305,2013,0,0,0,0,0,0
3523404,2013,112,"1,1",60,"0,6",52,"0,5"
3523503,2013,14,"0,7",7,"0,4",7,"0,4"
3523602,2013,24,"1,5",20,"1,2",4,"0,2"
3523701,2013,0,0,0,0,0,0
3523800,2013,0,0,0,0,0,0
3523909,2013,426,"2,7",391,"2,5",35,"0,2"
3524006,2013,86,"1,8",48,1,38,"0,8"
3524105,2013,120,"3,1",58,"1,5",62,"1,6"
3524204,2013,17,"2,6",17,"2,6",0,0
3524303,2013,136,"1,9",71,1,65,"0,9"
3524402,2013,421,"1,9",211,1,210,1
3524501,2013,177,"29,2",135,"22,3",42,"6,9"
3524600,2013,0,0,0,0,0,0
3524709,2013,80,"1,7",78,"1,6",2,0
3524808,2013,165,"3,5",70,"1,5",95,2
3524907,2013,0,0,0,0,0,0
3525003,2013,58,"0,5",44,"0,4",14,"0,1"
3525102,2013,0,0,0,0,0,0
3525201,2013,33,"1,3",12,"0,5",21,"0,8"
3525300,2013,860,"6,3",705,"5,2",155,"1,1"
3525409,2013,0,0,0,0,0,0
3525508,2013,24,2,17,"1,4",7,"0,6"
3525607,2013,0,0,0,0,0,0
3525706,2013,61,"1,8",34,1,27,"0,8"
3525805,2013,0,0,0,0,0,0
3525854,2013,0,0,0,0,0,0
3525904,2013,664,"1,7",308,"0,8",356,"0,9"
3526001,2013,52,"2,7",26,"1,4",26,"1,4"
3526100,2013,15,"0,8",15,"0,8",0,0
3526209,2013,9,"0,3",0,0,9,"0,3"
3526308,2013,0,0,0,0,0,0
3526407,2013,75,"2,9",58,"2,2",17,"0,7"
3526506,2013,0,0,0,0,0,0
3526605,2013,0,0,0,0,0,0
3526704,2013,127,"1,3",76,"0,8",51,"0,5"
3526803,2013,80,"1,3",57,"0,9",23,"0,4"
3526902,2013,431,"1,5",234,"0,8",197,"0,7"
3527009,2013,0,0,0,0,0,0
3527108,2013,446,"6,1",349,"4,8",97,"1,3"
3527207,2013,173,"2,1",105,"1,3",68,"0,8"
3527256,2013,0,0,0,0,0,0
3527306,2013,41,1,34,"0,8",7,"0,2"
3527405,2013,67,"3,3",48,"2,4",19,"0,9"
3527504,2013,0,0,0,0,0,0
3527603,2013,0,0,0,0,0,0
3527702,2013,32,"6,1",15,"2,9",17,"3,2"
3527801,2013,0,0,0,0,0,0
3527900,2013,0,0,0,0,0,0
3528007,2013,31,"1,9",18,"1,1",13,"0,8"
3528106,2013,24,"3,1",5,"0,6",19,"2,5"
3528205,2013,0,0,0,0,0,0
3528304,2013,0,0,0,0,0,0
3528403,2013,0,0,0,0,0,0
3528502,2013,47,"0,5",47,"0,5",0,0
3528601,2013,0,0,0,0,0,0
3528700,2013,0,0,0,0,0,0
3528809,2013,26,"1,9",26,"1,9",0,0
3528858,2013,0,0,0,0,0,0
3528908,2013,0,0,0,0,0,0
3529005,2013,895,4,750,"3,4",145,"0,7"
3529104,2013,0,0,0,0,0,0
3529203,2013,66,"2,7",41,"1,7",25,1
3529302,2013,164,"2,1",96,"1,2",68,"0,9"
3529401,2013,576,"1,3",292,"0,7",284,"0,7"
3529500,2013,0,0,0,0,0,0
3529609,2013,0,0,0,0,0,0
3529658,2013,0,0,0,0,0,0
3529708,2013,66,"3,2",47,"2,3",19,"0,9"
3529807,2013,0,0,0,0,0,0
3529906,2013,0,0,0,0,0,0
3530003,2013,0,0,0,0,0,0
3530102,2013,96,"3,4",96,"3,4",0,0
3530201,2013,0,0,0,0,0,0
3530300,2013,93,"1,7",29,"0,5",64,"1,2"
3530409,2013,0,0,0,0,0,0
3530508,2013,135,2,86,"1,3",49,"0,7"
3530607,2013,736,"1,8",561,"1,4",175,"0,4"
3530706,2013,328,"2,3",149,"1,1",179,"1,3"
3530805,2013,268,"3,1",140,"1,6",128,"1,5"
3530904,2013,0,0,0,0,0,0
3531001,2013,0,0,0,0,0,0
3531100,2013,44,"0,9",44,"0,9",0,0
3531209,2013,0,0,0,0,0,0
3531308,2013,109,"2,3",58,"1,2",51,"1,1"
3531407,2013,80,"3,6",35,"1,6",45,2
3531506,2013,70,"3,7",51,"2,7",19,1
3531605,2013,0,0,0,0,0,0
3531704,2013,0,0,0,0,0,0
3531803,2013,36,"0,7",29,"0,6",7,"0,1"
3531902,2013,45,"1,5",31,1,14,"0,5"
3532009,2013,13,"1,1",13,"1,1",0,0
3532058,2013,0,0,0,0,0,0
3532108,2013,0,0,0,0,0,0
3532157,2013,0,0,0,0,0,0
3532207,2013,0,0,0,0,0,0
3532306,2013,0,0,0,0,0,0
3532405,2013,24,"1,4",24,"1,4",0,0
3532504,2013,35,4,11,"1,3",24,"2,7"
3532603,2013,129,12,36,"3,3",93,"8,6"
3532702,2013,0,0,0,0,0,0
3532801,2013,0,0,0,0,0,0
3532827,2013,0,0,0,0,0,0
3532843,2013,0,0,0,0,0,0
3532868,2013,0,0,0,0,0,0
3532900,2013,12,"1,2",7,"0,7",5,"0,5"
3533007,2013,193,"9,8",42,"2,1",151,"7,7"
3533106,2013,0,0,0,0,0,0
3533205,2013,0,0,0,0,0,0
3533254,2013,0,0,0,0,0,0
3533304,2013,0,0,0,0,0,0
3533403,2013,53,1,53,1,0,0
3533502,2013,105,"2,8",38,1,67,"1,8"
3533601,2013,0,0,0,0,0,0
3533700,2013,0,0,0,0,0,0
3533809,2013,0,0,0,0,0,0
3533908,2013,98,"1,9",80,"1,6",18,"0,4"
3534005,2013,0,0,0,0,0,0
3534104,2013,0,0,0,0,0,0
3534203,2013,0,0,0,0,0,0
3534302,2013,98,"2,4",59,"1,5",39,1
3534401,2013,1009,"1,5",593,"0,9",416,"0,6"
3534500,2013,0,0,0,0,0,0
3534609,2013,90,"2,9",59,"1,9",31,1
3534708,2013,315,3,230,"2,2",85,"0,8"
3534757,2013,39,"4,4",10,"1,1",29,"3,3"
3534807,2013,0,0,0,0,0,0
3534906,2013,37,"2,8",29,"2,2",8,"0,6"
3535002,2013,0,0,0,0,0,0
3535101,2013,0,0,0,0,0,0
3535200,2013,24,"2,5",10,"1,1",14,"1,5"
3535309,2013,68,"3,2",44,"2,1",24,"1,1"
3535408,2013,65,"4,4",45,3,20,"1,4"
3535507,2013,97,"2,3",78,"1,8",19,"0,4"
3535606,2013,14,"0,8",12,"0,7",2,"0,1"
3535705,2013,0,0,0,0,0,0
3535804,2013,30,"1,6",30,"1,6",0,0
3535903,2013,0,0,0,0,0,0
3536000,2013,32,3,26,"2,4",6,"0,6"
3536109,2013,0,0,0,0,0,0
3536208,2013,152,"8,1",152,"8,1",0,0
3536257,2013,0,0,0,0,0,0
3536307,2013,35,"2,6",23,"1,7",12,"0,9"
3536406,2013,0,0,0,0,0,0
3536505,2013,84,"0,9",84,"0,9",0,0
3536570,2013,0,0,0,0,0,0
3536604,2013,24,"2,8",9,"1,1",15,"1,8"
3536703,2013,72,"1,7",52,"1,2",20,"0,5"
3536802,2013,0,0,0,0,0,0
3536901,2013,0,0,0,0,0,0
3537008,2013,53,"3,3",33,"2,1",20,"1,3"
3537107,2013,98,"2,3",88,2,10,"0,2"
3537156,2013,0,0,0,0,0,0
3537206,2013,0,0,0,0,0,0
3537305,2013,238,4,168,"2,8",70,"1,2"
3537404,2013,98,"3,9",65,"2,6",33,"1,3"
3537503,2013,0,0,0,0,0,0
3537602,2013,39,"0,6",39,"0,6",0,0
3537701,2013,0,0,0,0,0,0
3537800,2013,521,"9,9",471,9,50,1
3537909,2013,35,"1,3",27,1,8,"0,3"
3538006,2013,210,"1,4",134,"0,9",76,"0,5"
3538105,2013,0,0,0,0,0,0
3538204,2013,0,0,0,0,0,0
3538303,2013,0,0,0,0,0,0
3538501,2013,0,0,0,0,0,0
3538600,2013,37,"1,5",29,"1,1",8,"0,3"
3538709,2013,815,"2,2",312,"0,8",503,"1,4"
3538808,2013,80,"2,8",71,"2,5",9,"0,3"
3538907,2013,299,13,289,"12,6",10,"0,4"
3539004,2013,37,"3,5",9,"0,8",28,"2,6"
3539103,2013,0,0,0,0,0,0
3539202,2013,59,"2,3",59,"2,3",0,0
3539301,2013,87,"1,2",52,"0,7",35,"0,5"
3539400,2013,30,"2,4",26,"2,1",4,"0,3"
3539509,2013,50,"1,4",32,"0,9",18,"0,5"
3539608,2013,0,0,0,0,0,0
3539707,2013,0,0,0,0,0,0
3539806,2013,21,"0,2",21,"0,2",0,0
3539905,2013,0,0,0,0,0,0
3540002,2013,41,2,41,2,0,0
3540101,2013,0,0,0,0,0,0
3540200,2013,75,"1,7",45,1,30,"0,7"
3540259,2013,0,0,0,0,0,0
3540309,2013,0,0,0,0,0,0
3540408,2013,18,"4,3",8,"1,9",10,"2,4"
3540507,2013,0,0,0,0,0,0
3540606,2013,51,1,39,"0,8",12,"0,2"
3540705,2013,61,"1,2",37,"0,7",24,"0,5"
3540754,2013,0,0,0,0,0,0
3540804,2013,31,2,28,"1,8",3,"0,2"
3540853,2013,0,0,0,0,0,0
3540903,2013,0,0,0,0,0,0
3541000,2013,199,"0,7",113,"0,4",86,"0,3"
3541059,2013,0,0,0,0,0,0
3541109,2013,0,0,0,0,0,0
3541208,2013,51,"3,7",40,"2,9",11,"0,8"
3541307,2013,78,"1,9",68,"1,6",10,"0,2"
3541406,2013,1570,"7,4",1094,"5,2",476,"2,2"
3541505,2013,97,"2,6",75,2,22,"0,6"
3541604,2013,75,2,75,2,0,0
3541653,2013,0,0,0,0,0,0
3541703,2013,0,0,0,0,0,0
3541802,2013,0,0,0,0,0,0
3541901,2013,26,"2,2",26,"2,2",0,0
3542008,2013,0,0,0,0,0,0
3542107,2013,0,0,0,0,0,0
3542206,2013,98,"3,4",70,"2,4",28,1
3542305,2013,0,0,0,0,0,0
3542404,2013,24,"1,3",17,"0,9",7,"0,4"
3542503,2013,0,0,0,0,0,0
3542602,2013,105,"1,9",63,"1,2",42,"0,8"
3542701,2013,0,0,0,0,0,0
3542800,2013,0,0,0,0,0,0
3542909,2013,17,"1,4",11,"0,9",6,"0,5"
3543006,2013,36,2,35,"1,9",1,"0,1"
3543105,2013,0,0,0,0,0,0
3543204,2013,0,0,0,0,0,0
3543238,2013,0,0,0,0,0,0
3543253,2013,0,0,0,0,0,0
3543303,2013,164,"1,4",50,"0,4",114,1
3543402,2013,1980,"3,1",1369,"2,2",611,1
3543501,2013,0,0,0,0,0,0
3543600,2013,0,0,0,0,0,0
3543709,2013,0,0,0,0,0,0
3543808,2013,33,"3,3",25,"2,5",8,"0,8"
3543907,2013,478,"2,5",274,"1,4",204,"1,1"
3544004,2013,53,"1,7",38,"1,2",15,"0,5"
3544103,2013,0,0,0,0,0,0
3544202,2013,36,"3,3",7,"0,6",29,"2,7"
3544251,2013,57,3,57,3,0,0
3544301,2013,14,"1,4",14,"1,4",0,0
3544400,2013,0,0,0,0,0,0
3544509,2013,0,0,0,0,0,0
3544608,2013,0,0,0,0,0,0
3544707,2013,0,0,0,0,0,0
3544806,2013,0,0,0,0,0,0
3544905,2013,29,"2,7",19,"1,7",10,"0,9"
3545001,2013,24,"1,5",21,"1,3",3,"0,2"
3545100,2013,0,0,0,0,0,0
3545159,2013,0,0,0,0,0,0
3545209,2013,123,"1,1",70,"0,6",53,"0,5"
3545308,2013,1018,"24,6",992,24,26,"0,6"
3545407,2013,34,"3,8",22,"2,5",12,"1,4"
3545506,2013,0,0,0,0,0,0
3545605,2013,31,"2,1",11,"0,8",20,"1,4"
3545704,2013,0,0,0,0,0,0
3545803,2013,166,"0,9",133,"0,7",33,"0,2"
3546009,2013,0,0,0,0,0,0
3546108,2013,0,0,0,0,0,0
3546207,2013,0,0,0,0,0,0
3546256,2013,0,0,0,0,0,0
3546306,2013,46,"1,5",25,"0,8",21,"0,7"
3546405,2013,108,"2,4",65,"1,5",43,1
3546504,2013,0,0,0,0,0,0
3546603,2013,76,"2,6",33,"1,1",43,"1,4"
3546702,2013,0,0,0,0,0,0
3546801,2013,104,2,92,"1,8",12,"0,2"
3546900,2013,0,0,0,0,0,0
3547007,2013,2,"0,4",2,"0,4",0,0
3547106,2013,0,0,0,0,0,0
3547205,2013,0,0,0,0,0,0
3547304,2013,16,"0,1",16,"0,1",0,0
3547403,2013,0,0,0,0,0,0
3547502,2013,299,"11,3",271,"10,2",28,"1,1"
3547601,2013,30,"1,2",18,"0,7",12,"0,5"
3547650,2013,0,0,0,0,0,0
3547700,2013,56,"2,8",37,"1,8",19,"0,9"
3547809,2013,1476,"2,2",684,1,792,"1,2"
3547908,2013,12,"1,9",12,"1,9",0,0
3548005,2013,0,0,0,0,0,0
3548054,2013,0,0,0,0,0,0
3548104,2013,0,0,0,0,0,0
3548203,2013,0,0,0,0,0,0
3548302,2013,0,0,0,0,0,0
3548401,2013,0,0,0,0,0,0
3548500,2013,1613,"3,8",767,"1,8",846,2
3548609,2013,40,"3,8",26,"2,5",14,"1,3"
3548708,2013,1596,2,729,"0,9",867,"1,1"
3548807,2013,565,"3,8",187,"1,2",378,"2,5"
3548906,2013,419,"1,8",204,"0,9",215,"0,9"
3549003,2013,0,0,0,0,0,0
3549102,2013,198,"2,3",94,"1,1",104,"1,2"
3549201,2013,0,0,0,0,0,0
3549250,2013,0,0,0,0,0,0
3549300,2013,0,0,0,0,0,0
3549409,2013,115,"2,4",68,"1,4",47,1
3549508,2013,0,0,0,0,0,0
3549607,2013,0,0,0,0,0,0
3549706,2013,145,"2,8",89,"1,7",56,"1,1"
3549805,2013,1726,"4,1",992,"2,4",734,"1,7"
3549904,2013,1505,"2,3",833,"1,3",672,1
3549953,2013,0,0,0,0,0,0
3550001,2013,26,"2,5",11,"1,1",15,"1,4"
3550100,2013,43,"1,1",36,"0,9",7,"0,2"
3550209,2013,46,"1,5",46,"1,5",0,0
3550308,2013,28700,"2,5",15195,"1,3",13505,"1,2"
3550407,2013,62,"1,9",37,"1,1",25,"0,8"
3550506,2013,0,0,0,0,0,0
3550605,2013,103,"1,3",54,"0,7",49,"0,6"
3550704,2013,101,"1,3",93,"1,2",8,"0,1"
3550803,2013,30,"2,5",26,"2,2",4,"0,3"
3550902,2013,40,"2,8",32,"2,2",8,"0,6"
3551009,2013,331,1,276,"0,8",55,"0,2"
3551108,2013,0,0,0,0,0,0
3551207,2013,0,0,0,0,0,0
3551306,2013,0,0,0,0,0,0
3551405,2013,0,0,0,0,0,0
3551504,2013,58,"1,4",43,"1,1",15,"0,4"
3551603,2013,55,"2,1",42,"1,6",13,"0,5"
3551702,2013,155,"1,4",75,"0,7",80,"0,7"
3551801,2013,0,0,0,0,0,0
3551900,2013,0,0,0,0,0,0
3552007,2013,3,"0,5",3,"0,5",0,0
3552106,2013,62,"1,7",54,"1,4",8,"0,2"
3552205,2013,2431,4,1896,"3,1",535,"0,9"
3552304,2013,20,"2,7",20,"2,7",0,0
3552403,2013,184,"0,7",180,"0,7",4,0
3552502,2013,170,"0,6",79,"0,3",91,"0,3"
3552551,2013,0,0,0,0,0,0
3552601,2013,30,"2,6",11,1,19,"1,6"
3552700,2013,35,"2,3",22,"1,5",13,"0,9"
3552809,2013,563,"2,2",332,"1,3",231,"0,9"
3552908,2013,0,0,0,0,0,0
3553005,2013,31,"2,7",24,"2,1",7,"0,6"
3553104,2013,0,0,0,0,0,0
3553203,2013,4,"0,6",4,"0,6",0,0
3553302,2013,34,"1,5",25,"1,1",9,"0,4"
3553401,2013,72,"2,9",38,"1,6",34,"1,4"
3553500,2013,0,0,0,0,0,0
3553609,2013,24,"1,9",18,"1,4",6,"0,5"
3553658,2013,0,0,0,0,0,0
3553708,2013,120,"2,2",73,"1,3",47,"0,9"
3553807,2013,54,"2,4",36,"1,6",18,"0,8"
3553856,2013,0,0,0,0,0,0
3553906,2013,0,0,0,0,0,0
3553955,2013,0,0,0,0,0,0
3554003,2013,208,"1,9",93,"0,8",115,1
3554102,2013,452,"1,6",325,"1,1",127,"0,4"
3554201,2013,0,0,0,0,0,0
3554300,2013,58,"2,7",52,"2,4",6,"0,3"
3554409,2013,34,"3,9",30,"3,5",4,"0,5"
3554508,2013,68,"1,8",41,"1,1",27,"0,7"
3554607,2013,0,0,0,0,0,0
3554656,2013,0,0,0,0,0,0
3554706,2013,20,"2,1",13,"1,4",7,"0,7"
3554755,2013,0,0,0,0,0,0
3554805,2013,30,"0,7",0,0,30,"0,7"
3554904,2013,0,0,0,0,0,0
3554953,2013,0,0,0,0,0,0
3555000,2013,864,"13,7",791,"12,5",73,"1,2"
3555109,2013,48,"3,3",30,"2,1",18,"1,2"
3555208,2013,0,0,0,0,0,0
3555307,2013,0,0,0,0,0,0
3555356,2013,0,0,0,0,0,0
3555406,2013,76,"0,9",69,"0,8",7,"0,1"
3555505,2013,0,0,0,0,0,0
3555604,2013,0,0,0,0,0,0
3555703,2013,0,0,0,0,0,0
3555802,2013,26,3,24,"2,7",2,"0,2"
3555901,2013,0,0,0,0,0,0
3556008,2013,34,"2,6",15,"1,2",19,"1,5"
3556107,2013,0,0,0,0,0,0
3556206,2013,169,"1,5",63,"0,6",106,"0,9"
3556305,2013,55,"2,4",31,"1,3",24,1
3556354,2013,0,0,0,0,0,0
3556404,2013,77,"1,9",47,"1,2",30,"0,8"
3556453,2013,0,0,0,0,0,0
3556503,2013,27,"0,2",27,"0,2",0,0
3556602,2013,0,0,0,0,0,0
3556701,2013,95,"1,4",0,0,95,"1,4"
3556800,2013,48,"2,7",30,"1,7",18,1
3556909,2013,9,"1,2",9,"1,2",0,0
3556958,2013,0,0,0,0,0,0
3557006,2013,146,"1,3",84,"0,7",62,"0,6"
3557105,2013,240,"2,8",118,"1,4",122,"1,4"
3557154,2013,0,0,0,0,0,0
3557204,2013,48,4,27,"2,2",21,"1,7"
3557303,2013,0,0,0,0,0,0
3500105,2014,279,"8,2",240,"7,1",39,"1,2"
3500204,2014,0,0,0,0,0,0
3500303,2014,0,0,0,0,0,0
3500402,2014,0,0,0,0,0,0
3500501,2014,42,"2,4",30,"1,7",12,"0,7"
3500550,2014,0,0,0,0,0,0
3500600,2014,4,"1,4",4,"1,4",0,0
3500709,2014,60,"1,7",38,"1,1",22,"0,6"
3500758,2014,0,0,0,0,0,0
3500808,2014,0,0,0,0,0,0
3500907,2014,0,0,0,0,0,0
3501004,2014,31,2,25,"1,6",6,"0,4"
3501103,2014,22,"5,4",19,"4,7",3,"0,7"
3501152,2014,0,0,0,0,0,0
3501202,2014,0,0,0,0,0,0
3501301,2014,20,"0,8",18,"0,8",2,"0,1"
3501400,2014,0,0,0,0,0,0
3501509,2014,0,0,0,0,0,0
3501608,2014,702,"3,2",340,"1,5",362,"1,6"
3501707,2014,204,"5,5",204,"5,5",0,0
3501806,2014,0,0,0,0,0,0
3501905,2014,358,"5,3",243,"3,6",115,"1,7"
3502002,2014,0,0,0,0,0,0
3502101,2014,135,"2,4",110,2,25,"0,4"
3502200,2014,57,"2,5",54,"2,3",3,"0,1"
3502309,2014,0,0,0,0,0,0
3502408,2014,0,0,0,0,0,0
3502507,2014,104,"2,9",70,2,34,1
3502606,2014,30,"6,9",8,"1,9",22,"5,1"
3502705,2014,51,"2,1",45,"1,8",6,"0,2"
3502754,2014,4,"0,2",0,0,4,"0,2"
3502804,2014,616,"3,3",478,"2,6",138,"0,7"
3502903,2014,126,"4,3",0,0,126,"4,3"
3503000,2014,0,0,0,0,0,0
3503109,2014,16,"2,6",16,"2,6",0,0
3503158,2014,0,0,0,0,0,0
3503208,2014,576,"2,7",262,"1,2",314,"1,4"
3503307,2014,565,"4,6",307,"2,5",258,"2,1"
3503356,2014,0,0,0,0,0,0
3503406,2014,28,"3,5",17,"2,1",11,"1,4"
3503505,2014,0,0,0,0,0,0
3503604,2014,0,0,0,0,0,0
3503703,2014,25,"2,8",4,"0,5",21,"2,4"
3503802,2014,12,"0,3",0,0,12,"0,3"
3503901,2014,82,1,15,"0,2",67,"0,8"
3503950,2014,0,0,0,0,0,0
3504008,2014,314,"3,2",195,2,119,"1,2"
3504107,2014,300,"2,3",55,"0,4",245,"1,9"
3504206,2014,51,"3,6",30,"2,1",21,"1,5"
3504305,2014,0,0,0,0,0,0
3504404,2014,0,0,0,0,0,0
3504503,2014,153,"1,8",95,"1,1",58,"0,7"
3504602,2014,0,0,0,0,0,0
3504701,2014,0,0,0,0,0,0
3504800,2014,0,0,0,0,0,0
3504909,2014,15,"1,4",15,"1,4",0,0
3505005,2014,0,0,0,0,0,0
3505104,2014,0,0,0,0,0,0
3505203,2014,68,"2,1",52,"1,6",16,"0,5"
3505302,2014,101,"2,9",68,"1,9",33,"0,9"
3505351,2014,0,0,0,0,0,0
3505401,2014,0,0,0,0,0,0
3505500,2014,604,"5,3",501,"4,4",103,"0,9"
3505609,2014,0,0,0,0,0,0
3505708,2014,497,2,401,"1,6",96,"0,4"
3505807,2014,35,"1,7",28,"1,4",7,"0,3"
3505906,2014,139,"2,4",94,"1,6",45,"0,8"
3506003,2014,1128,"3,2",723,"2,1",405,"1,1"
3506102,2014,129,"1,7",81,"1,1",48,"0,6"
3506201,2014,0,0,0,0,0,0
3506300,2014,50,"4,6",20,"1,9",30,"2,8"
3506359,2014,46,"0,9",46,"0,9",0,0
3506409,2014,36,"4,9",36,"4,9",0,0
3506508,2014,242,"2,1",155,"1,4",87,"0,8"
3506607,2014,0,0,0,0,0,0
3506706,2014,15,"1,1",13,"0,9",2,"0,1"
3506805,2014,35,"3,1",30,"2,6",5,"0,4"
3506904,2014,0,0,0,0,0,0
3507001,2014,55,"1,1",39,"0,7",16,"0,3"
3507100,2014,11,"0,5",11,"0,5",0,0
3507159,2014,0,0,0,0,0,0
3507209,2014,0,0,0,0,0,0
3507308,2014,0,0,0,0,0,0
3507407,2014,27,"1,8",17,"1,1",10,"0,7"
3507456,2014,0,0,0,0,0,0
3507506,2014,604,"4,5",497,"3,7",107,"0,8"
3507605,2014,333,"2,2",230,"1,5",103,"0,7"
3507704,2014,0,0,0,0,0,0
3507753,2014,0,0,0,0,0,0
3507803,2014,0,0,0,0,0,0
3507902,2014,41,"1,8",35,"1,6",6,"0,3"
3508009,2014,0,0,0,0,0,0
3508108,2014,42,"2,6",22,"1,4",20,"1,3"
3508207,2014,0,0,0,0,0,0
3508306,2014,0,0,0,0,0,0
3508405,2014,36,"0,8",28,"0,6",8,"0,2"
3508504,2014,145,"1,7",77,"0,9",68,"0,8"
3508603,2014,47,"1,5",40,"1,3",7,"0,2"
3508702,2014,64,"3,4",64,"3,4",0,0
3508801,2014,58,"3,4",47,"2,8",11,"0,7"
3508900,2014,0,0,0,0,0,0
3509007,2014,112,"1,2",58,"0,6",54,"0,6"
3509106,2014,0,0,0,0,0,0
3509205,2014,171,"2,5",71,1,100,"1,4"
3509254,2014,13,"0,5",13,"0,5",0,0
3509304,2014,32,"3,2",26,"2,6",6,"0,6"
3509403,2014,73,3,55,"2,3",18,"0,7"
3509452,2014,0,0,0,0,0,0
3509502,2014,2959,"2,6",1445,"1,3",1514,"1,3"
3509601,2014,56,"0,7",56,"0,7",0,0
3509700,2014,242,5,195,4,47,1
3509809,2014,0,0,0,0,0,0
3509908,2014,0,0,0,0,0,0
3509957,2014,0,0,0,0,0,0
3510005,2014,30,1,25,"0,8",5,"0,2"
3510104,2014,0,0,0,0,0,0
3510153,2014,0,0,0,0,0,0
3510203,2014,67,"1,5",49,"1,1",18,"0,4"
3510302,2014,0,0,0,0,0,0
3510401,2014,96,"1,9",46,"0,9",50,1
3510500,2014,158,"1,5",120,"1,1",38,"0,4"
3510609,2014,353,"0,9",263,"0,7",90,"0,2"
3510708,2014,31,"2,6",14,"1,2",17,"1,4"
3510807,2014,412,"14,3",395,"13,7",17,"0,6"
3510906,2014,0,0,0,0,0,0
3511003,2014,31,"1,6",30,"1,6",1,"0,1"
3511102,2014,514,"4,5",373,"3,2",141,"1,2"
3511201,2014,0,0,0,0,0,0
3511300,2014,0,0,0,0,0,0
3511409,2014,51,"2,8",33,"1,8",18,1
3511508,2014,43,1,31,"0,7",12,"0,3"
3511607,2014,30,"1,8",17,1,13,"0,8"
3511706,2014,33,"2,1",26,"1,6",7,"0,4"
3511904,2014,30,"3,9",20,"2,6",10,"1,3"
3512001,2014,47,"2,7",40,"2,3",7,"0,4"
3512100,2014,30,5,20,"3,3",10,"1,7"
3512209,2014,52,2,41,"1,6",11,"0,4"
3512308,2014,42,"2,5",42,"2,5",0,0
3512407,2014,0,0,0,0,0,0
3512506,2014,0,0,0,0,0,0
3512605,2014,0,0,0,0,0,0
3512704,2014,0,0,0,0,0,0
3512803,2014,90,"1,4",63,1,27,"0,4"
3512902,2014,0,0,0,0,0,0
3513009,2014,287,"1,3",109,"0,5",178,"0,8"
3513108,2014,15,"0,5",13,"0,4",2,"0,1"
3513207,2014,0,0,0,0,0,0
3513306,2014,0,0,0,0,0,0
3513405,2014,156,2,111,"1,4",45,"0,6"
3513504,2014,138,"1,1",134,"1,1",4,0
3513603,2014,44,2,29,"1,3",15,"0,7"
3513702,2014,38,"1,2",23,"0,7",15,"0,5"
3513801,2014,635,"1,6",566,"1,4",69,"0,2"
3513850,2014,0,0,0,0,0,0
3513900,2014,198,"17,9",198,"17,9",0,0
3514007,2014,0,0,0,0,0,0
3514106,2014,67,"2,6",47,"1,8",20,"0,8"
3514205,2014,0,0,0,0,0,0
3514304,2014,18,"2,1",12,"1,4",6,"0,7"
3514403,2014,143,"3,2",108,"2,5",35,"0,8"
3514502,2014,82,"6,8",77,"6,3",5,"0,4"
3514601,2014,0,0,0,0,0,0
3514700,2014,0,0,0,0,0,0
3514809,2014,2,"0,1",2,"0,1",0,0
3514908,2014,6,"0,4",6,"0,4",0,0
3514924,2014,0,0,0,0,0,0
3514957,2014,0,0,0,0,0,0
3515004,2014,72,"0,3",72,"0,3",0,0
3515103,2014,16,"0,2",16,"0,2",0,0
3515129,2014,0,0,0,0,0,0
3515152,2014,0,0,0,0,0,0
3515186,2014,458,"10,8",369,"8,7",89,"2,1"
3515194,2014,0,0,0,0,0,0
3515202,2014,50,"6,1",30,"3,7",20,"2,4"
3515301,2014,0,0,0,0,0,0
3515350,2014,0,0,0,0,0,0
3515400,2014,26,"1,7",17,"1,1",9,"0,6"
3515509,2014,180,"2,8",90,"1,4",90,"1,4"
3515608,2014,0,0,0,0,0,0
3515657,2014,0,0,0,0,0,0
3515707,2014,258,"1,4",258,"1,4",0,0
3515806,2014,0,0,0,0,0,0
3515905,2014,0,0,0,0,0,0
3516002,2014,47,"3,8",30,"2,4",17,"1,4"
3516101,2014,0,0,0,0,0,0
3516200,2014,720,"2,2",456,"1,4",264,"0,8"
3516309,2014,144,"0,9",111,"0,7",33,"0,2"
3516408,2014,719,"5,1",427,"3,1",292,"2,1"
3516507,2014,0,0,0,0,0,0
3516606,2014,45,"6,6",24,"3,5",21,"3,1"
3516705,2014,376,"8,8",331,"7,7",45,"1,1"
3516804,2014,0,0,0,0,0,0
3516853,2014,0,0,0,0,0,0
3516903,2014,32,3,8,"0,7",24,"2,2"
3517000,2014,51,"4,7",42,"3,9",9,"0,8"
3517109,2014,0,0,0,0,0,0
3517208,2014,0,0,0,0,0,0
3517307,2014,0,0,0,0,0,0
3517406,2014,60,"1,6",42,"1,1",18,"0,5"
3517505,2014,0,0,0,0,0,0
3517604,2014,19,"1,1",19,"1,1",0,0
3517703,2014,30,"1,5",22,"1,1",8,"0,4"
3517802,2014,27,"3,2",20,"2,4",7,"0,8"
3517901,2014,0,0,0,0,0,0
3518008,2014,0,0,0,0,0,0
3518107,2014,0,0,0,0,0,0
3518206,2014,74,"2,4",30,1,44,"1,4"
3518305,2014,35,"1,3",29,"1,1",6,"0,2"
3518404,2014,303,"2,6",210,"1,8",93,"0,8"
3518503,2014,0,0,0,0,0,0
3518602,2014,72,"1,9",50,"1,4",22,"0,6"
3518701,2014,331,"1,1",263,"0,9",68,"0,2"
3518800,2014,1846,"1,4",1428,"1,1",418,"0,3"
3518859,2014,0,0,0,0,0,0
3518909,2014,0,0,0,0,0,0
3519006,2014,32,"3,6",32,"3,6",0,0
3519055,2014,0,0,0,0,0,0
3519071,2014,91,"0,4",62,"0,3",29,"0,1"
3519105,2014,27,"2,6",25,"2,4",2,"0,2"
3519204,2014,19,3,15,"2,4",4,"0,6"
3519253,2014,0,0,0,0,0,0
3519303,2014,32,1,32,1,0,0
3519402,2014,27,"2,4",8,"0,7",19,"1,7"
3519501,2014,0,0,0,0,0,0
3519600,2014,99,"1,8",46,"0,8",53,1
3519709,2014,67,"0,9",63,"0,9",4,"0,1"
3519808,2014,0,0,0,0,0,0
3519907,2014,20,"2,6",20,"2,6",0,0
3520004,2014,63,"2,7",55,"2,3",8,"0,3"
3520103,2014,50,"1,7",32,"1,1",18,"0,6"
3520202,2014,15,"1,7",15,"1,7",0,0
3520301,2014,13,"0,4",13,"0,4",0,0
3520400,2014,40,"1,3",37,"1,2",3,"0,1"
3520426,2014,0,0,0,0,0,0
3520442,2014,116,"4,6",74,"2,9",42,"1,7"
3520509,2014,372,"1,7",268,"1,2",104,"0,5"
3520608,2014,0,0,0,0,0,0
3520707,2014,40,"10,3",5,"1,3",35,9
3520806,2014,0,0,0,0,0,0
3520905,2014,49,"3,5",29,"2,1",20,"1,4"
3521002,2014,15,"0,5",15,"0,5",0,0
3521101,2014,0,0,0,0,0,0
3521150,2014,0,0,0,0,0,0
3521200,2014,0,0,0,0,0,0
3521309,2014,49,"3,3",39,"2,6",10,"0,7"
3521408,2014,0,0,0,0,0,0
3521507,2014,0,0,0,0,0,0
3521606,2014,0,0,0,0,0,0
3521705,2014,70,4,65,"3,7",5,"0,3"
3521804,2014,41,"1,6",40,"1,6",1,0
3521903,2014,30,"2,1",13,"0,9",17,"1,2"
3522000,2014,0,0,0,0,0,0
3522109,2014,74,"0,8",74,"0,8",0,0
3522158,2014,0,0,0,0,0,0
3522208,2014,444,"2,8",197,"1,2",247,"1,5"
3522307,2014,129,"0,9",107,"0,7",22,"0,1"
3522406,2014,164,"1,8",122,"1,4",42,"0,5"
3522505,2014,269,"1,3",205,1,64,"0,3"
3522604,2014,1276,"18,2",737,"10,5",539,"7,7"
3522653,2014,0,0,0,0,0,0
3522703,2014,76,"1,9",45,"1,1",31,"0,8"
3522802,2014,46,"3,2",27,"1,9",19,"1,3"
3522901,2014,33,"2,6",22,"1,7",11,"0,9"
3523008,2014,0,0,0,0,0,0
3523107,2014,224,"0,7",224,"0,7",0,0
3523206,2014,93,"1,9",78,"1,6",15,"0,3"
3523305,2014,0,0,0,0,0,0
3523404,2014,112,1,60,"0,6",52,"0,5"
3523503,2014,14,"0,7",7,"0,4",7,"0,4"
3523602,2014,8,"0,5",8,"0,5",0,0
3523701,2014,0,0,0,0,0,0
3523800,2014,0,0,0,0,0,0
3523909,2014,426,"2,7",391,"2,4",35,"0,2"
3524006,2014,86,"1,7",48,"0,9",38,"0,8"
3524105,2014,120,3,58,"1,5",62,"1,6"
3524204,2014,17,"2,6",17,"2,6",0,0
3524303,2014,143,2,56,"0,8",87,"1,2"
3524402,2014,421,"1,9",211,1,210,1
3524501,2014,179,"28,9",151,"24,4",28,"4,5"
3524600,2014,0,0,0,0,0,0
3524709,2014,80,"1,6",78,"1,6",2,0
3524808,2014,165,"3,5",112,"2,4",53,"1,1"
3524907,2014,0,0,0,0,0,0
3525003,2014,40,"0,3",26,"0,2",14,"0,1"
3525102,2014,0,0,0,0,0,0
3525201,2014,33,"1,3",12,"0,5",21,"0,8"
3525300,2014,860,"6,2",705,"5,1",155,"1,1"
3525409,2014,0,0,0,0,0,0
3525508,2014,24,2,17,"1,4",7,"0,6"
3525607,2014,0,0,0,0,0,0
3525706,2014,61,"1,8",40,"1,2",21,"0,6"
3525805,2014,0,0,0,0,0,0
3525854,2014,0,0,0,0,0,0
3525904,2014,695,"1,8",321,"0,8",374,1
3526001,2014,52,"2,7",26,"1,3",26,"1,3"
3526100,2014,15,"0,8",15,"0,8",0,0
3526209,2014,9,"0,3",0,0,9,"0,3"
3526308,2014,0,0,0,0,0,0
3526407,2014,47,"1,8",32,"1,2",15,"0,6"
3526506,2014,0,0,0,0,0,0
3526605,2014,0,0,0,0,0,0
3526704,2014,127,"1,3",76,"0,8",51,"0,5"
3526803,2014,80,"1,3",57,"0,9",23,"0,4"
3526902,2014,407,"1,4",216,"0,8",191,"0,7"
3527009,2014,0,0,0,0,0,0
3527108,2014,446,"6,1",349,"4,8",97,"1,3"
3527207,2014,165,2,84,1,81,1
3527256,2014,0,0,0,0,0,0
3527306,2014,41,1,34,"0,8",7,"0,2"
3527405,2014,58,"2,8",38,"1,9",20,1
3527504,2014,0,0,0,0,0,0
3527603,2014,0,0,0,0,0,0
3527702,2014,32,6,15,"2,8",17,"3,2"
3527801,2014,0,0,0,0,0,0
3527900,2014,0,0,0,0,0,0
3528007,2014,31,"1,9",18,"1,1",13,"0,8"
3528106,2014,24,"3,1",13,"1,7",11,"1,4"
3528205,2014,0,0,0,0,0,0
3528304,2014,0,0,0,0,0,0
3528403,2014,0,0,0,0,0,0
3528502,2014,47,"0,5",47,"0,5",0,0
3528601,2014,0,0,0,0,0,0
3528700,2014,0,0,0,0,0,0
3528809,2014,26,"1,9",26,"1,9",0,0
3528858,2014,0,0,0,0,0,0
3528908,2014,0,0,0,0,0,0
3529005,2014,860,"3,9",729,"3,3",131,"0,6"
3529104,2014,0,0,0,0,0,0
3529203,2014,66,"2,7",41,"1,7",25,1
3529302,2014,169,"2,2",101,"1,3",68,"0,9"
3529401,2014,592,"1,4",316,"0,7",276,"0,6"
3529500,2014,0,0,0,0,0,0
3529609,2014,0,0,0,0,0,0
3529658,2014,0,0,0,0,0,0
3529708,2014,66,"3,2",47,"2,3",19,"0,9"
3529807,2014,0,0,0,0,0,0
3529906,2014,0,0,0,0,0,0
3530003,2014,0,0,0,0,0,0
3530102,2014,90,"3,2",90,"3,2",0,0
3530201,2014,0,0,0,0,0,0
3530300,2014,93,"1,7",29,"0,5",64,"1,2"
3530409,2014,0,0,0,0,0,0
3530508,2014,135,2,86,"1,3",49,"0,7"
3530607,2014,832,2,607,"1,5",225,"0,6"
3530706,2014,333,"2,3",154,"1,1",179,"1,3"
3530805,2014,254,"2,9",131,"1,5",123,"1,4"
3530904,2014,0,0,0,0,0,0
3531001,2014,0,0,0,0,0,0
3531100,2014,44,"0,9",44,"0,9",0,0
3531209,2014,0,0,0,0,0,0
3531308,2014,109,"2,3",58,"1,2",51,"1,1"
3531407,2014,80,"3,5",30,"1,3",50,"2,2"
3531506,2014,70,"3,8",51,"2,7",19,1
3531605,2014,0,0,0,0,0,0
3531704,2014,0,0,0,0,0,0
3531803,2014,36,"0,7",29,"0,5",7,"0,1"
3531902,2014,45,"1,5",31,1,14,"0,5"
3532009,2014,13,"1,1",13,"1,1",0,0
3532058,2014,0,0,0,0,0,0
3532108,2014,0,0,0,0,0,0
3532157,2014,0,0,0,0,0,0
3532207,2014,0,0,0,0,0,0
3532306,2014,0,0,0,0,0,0
3532405,2014,24,"1,4",24,"1,4",0,0
3532504,2014,35,4,11,"1,3",24,"2,8"
3532603,2014,129,12,37,"3,4",92,"8,5"
3532702,2014,0,0,0,0,0,0
3532801,2014,0,0,0,0,0,0
3532827,2014,0,0,0,0,0,0
3532843,2014,0,0,0,0,0,0
3532868,2014,0,0,0,0,0,0
3532900,2014,12,"1,2",7,"0,7",5,"0,5"
3533007,2014,193,"9,7",37,"1,9",156,"7,8"
3533106,2014,0,0,0,0,0,0
3533205,2014,0,0,0,0,0,0
3533254,2014,0,0,0,0,0,0
3533304,2014,0,0,0,0,0,0
3533403,2014,53,1,53,1,0,0
3533502,2014,105,"2,8",35,"0,9",70,"1,9"
3533601,2014,0,0,0,0,0,0
3533700,2014,0,0,0,0,0,0
3533809,2014,0,0,0,0,0,0
3533908,2014,99,"1,9",79,"1,5",20,"0,4"
3534005,2014,0,0,0,0,0,0
3534104,2014,0,0,0,0,0,0
3534203,2014,0,0,0,0,0,0
3534302,2014,98,"2,4",59,"1,4",39,1
3534401,2014,992,"1,5",592,"0,9",400,"0,6"
3534500,2014,0,0,0,0,0,0
3534609,2014,90,"2,9",59,"1,9",31,1
3534708,2014,315,3,230,"2,2",85,"0,8"
3534757,2014,39,"4,3",10,"1,1",29,"3,2"
3534807,2014,0,0,0,0,0,0
3534906,2014,37,"2,8",32,"2,4",5,"0,4"
3535002,2014,0,0,0,0,0,0
3535101,2014,0,0,0,0,0,0
3535200,2014,24,"2,6",10,"1,1",14,"1,5"
3535309,2014,68,"3,2",44,"2,1",24,"1,1"
3535408,2014,36,"2,4",35,"2,4",1,"0,1"
3535507,2014,97,"2,3",78,"1,8",19,"0,4"
3535606,2014,14,"0,8",12,"0,7",2,"0,1"
3535705,2014,0,0,0,0,0,0
3535804,2014,30,"1,6",30,"1,6",0,0
3535903,2014,0,0,0,0,0,0
3536000,2014,32,3,26,"2,4",6,"0,6"
3536109,2014,0,0,0,0,0,0
3536208,2014,151,8,151,8,0,0
3536257,2014,0,0,0,0,0,0
3536307,2014,35,"2,6",23,"1,7",12,"0,9"
3536406,2014,0,0,0,0,0,0
3536505,2014,84,"0,9",84,"0,9",0,0
3536570,2014,0,0,0,0,0,0
3536604,2014,24,"2,8",4,"0,5",20,"2,3"
3536703,2014,72,"1,7",52,"1,2",20,"0,5"
3536802,2014,0,0,0,0,0,0
3536901,2014,0,0,0,0,0,0
3537008,2014,53,"3,3",33,"2,1",20,"1,3"
3537107,2014,49,"1,1",49,"1,1",0,0
3537156,2014,0,0,0,0,0,0
3537206,2014,0,0,0,0,0,0
3537305,2014,238,4,168,"2,8",70,"1,2"
3537404,2014,98,"3,9",65,"2,6",33,"1,3"
3537503,2014,0,0,0,0,0,0
3537602,2014,39,"0,6",39,"0,6",0,0
3537701,2014,0,0,0,0,0,0
3537800,2014,521,"9,9",471,"8,9",50,"0,9"
3537909,2014,35,"1,3",27,1,8,"0,3"
3538006,2014,199,"1,3",127,"0,8",72,"0,5"
3538105,2014,0,0,0,0,0,0
3538204,2014,0,0,0,0,0,0
3538303,2014,0,0,0,0,0,0
3538501,2014,0,0,0,0,0,0
3538600,2014,37,"1,4",29,"1,1",8,"0,3"
3538709,2014,801,"2,1",309,"0,8",492,"1,3"
3538808,2014,72,"2,5",54,"1,9",18,"0,6"
3538907,2014,299,13,289,"12,6",10,"0,4"
3539004,2014,41,"3,8",9,"0,8",32,3
3539103,2014,0,0,0,0,0,0
3539202,2014,59,"2,3",59,"2,3",0,0
3539301,2014,91,"1,3",55,"0,8",36,"0,5"
3539400,2014,30,"2,4",26,"2,1",4,"0,3"
3539509,2014,50,"1,4",32,"0,9",18,"0,5"
3539608,2014,0,0,0,0,0,0
3539707,2014,0,0,0,0,0,0
3539806,2014,30,"0,3",30,"0,3",0,0
3539905,2014,0,0,0,0,0,0
3540002,2014,41,2,41,2,0,0
3540101,2014,0,0,0,0,0,0
3540200,2014,45,1,29,"0,7",16,"0,4"
3540259,2014,0,0,0,0,0,0
3540309,2014,0,0,0,0,0,0
3540408,2014,18,"4,4",6,"1,5",12,"2,9"
3540507,2014,0,0,0,0,0,0
3540606,2014,51,1,39,"0,8",12,"0,2"
3540705,2014,61,"1,2",37,"0,7",24,"0,5"
3540754,2014,0,0,0,0,0,0
3540804,2014,31,"1,9",28,"1,8",3,"0,2"
3540853,2014,0,0,0,0,0,0
3540903,2014,0,0,0,0,0,0
3541000,2014,189,"0,7",113,"0,4",76,"0,3"
3541059,2014,0,0,0,0,0,0
3541109,2014,0,0,0,0,0,0
3541208,2014,51,"3,7",40,"2,9",11,"0,8"
3541307,2014,78,"1,9",68,"1,6",10,"0,2"
3541406,2014,1538,"7,2",1088,"5,1",450,"2,1"
3541505,2014,97,"2,6",75,2,22,"0,6"
3541604,2014,75,2,75,2,0,0
3541653,2014,0,0,0,0,0,0
3541703,2014,0,0,0,0,0,0
3541802,2014,0,0,0,0,0,0
3541901,2014,26,"2,2",26,"2,2",0,0
3542008,2014,0,0,0,0,0,0
3542107,2014,0,0,0,0,0,0
3542206,2014,98,"3,4",70,"2,4",28,1
3542305,2014,0,0,0,0,0,0
3542404,2014,24,"1,3",17,"0,9",7,"0,4"
3542503,2014,0,0,0,0,0,0
3542602,2014,105,"1,9",63,"1,2",42,"0,8"
3542701,2014,0,0,0,0,0,0
3542800,2014,0,0,0,0,0,0
3542909,2014,17,"1,4",11,"0,9",6,"0,5"
3543006,2014,36,2,35,2,1,"0,1"
3543105,2014,0,0,0,0,0,0
3543204,2014,0,0,0,0,0,0
3543238,2014,0,0,0,0,0,0
3543253,2014,0,0,0,0,0,0
3543303,2014,164,"1,4",50,"0,4",114,1
3543402,2014,2051,"3,2",1387,"2,2",664,1
3543501,2014,0,0,0,0,0,0
3543600,2014,0,0,0,0,0,0
3543709,2014,0,0,0,0,0,0
3543808,2014,33,"3,4",25,"2,5",8,"0,8"
3543907,2014,482,"2,5",278,"1,4",204,"1,1"
3544004,2014,53,"1,7",38,"1,2",15,"0,5"
3544103,2014,0,0,0,0,0,0
3544202,2014,36,"3,3",7,"0,6",29,"2,7"
3544251,2014,57,3,57,3,0,0
3544301,2014,14,"1,4",14,"1,4",0,0
3544400,2014,0,0,0,0,0,0
3544509,2014,0,0,0,0,0,0
3544608,2014,0,0,0,0,0,0
3544707,2014,0,0,0,0,0,0
3544806,2014,0,0,0,0,0,0
3544905,2014,29,"2,6",19,"1,7",10,"0,9"
3545001,2014,24,"1,5",21,"1,3",3,"0,2"
3545100,2014,0,0,0,0,0,0
3545159,2014,0,0,0,0,0,0
3545209,2014,123,"1,1",70,"0,6",53,"0,5"
3545308,2014,1026,"24,5",1000,"23,9",26,"0,6"
3545407,2014,34,"3,8",22,"2,5",12,"1,3"
3545506,2014,0,0,0,0,0,0
3545605,2014,31,"2,1",11,"0,8",20,"1,4"
3545704,2014,0,0,0,0,0,0
3545803,2014,159,"0,9",100,"0,5",59,"0,3"
3546009,2014,0,0,0,0,0,0
3546108,2014,0,0,0,0,0,0
3546207,2014,0,0,0,0,0,0
3546256,2014,0,0,0,0,0,0
3546306,2014,46,"1,5",25,"0,8",21,"0,7"
3546405,2014,100,"2,2",65,"1,5",35,"0,8"
3546504,2014,0,0,0,0,0,0
3546603,2014,76,"2,5",33,"1,1",43,"1,4"
3546702,2014,0,0,0,0,0,0
3546801,2014,101,"1,9",82,"1,6",19,"0,4"
3546900,2014,0,0,0,0,0,0
3547007,2014,8,"1,4",8,"1,4",0,0
3547106,2014,0,0,0,0,0,0
3547205,2014,0,0,0,0,0,0
3547304,2014,16,"0,1",16,"0,1",0,0
3547403,2014,0,0,0,0,0,0
3547502,2014,299,"11,3",276,"10,4",23,"0,9"
3547601,2014,30,"1,2",18,"0,7",12,"0,5"
3547650,2014,0,0,0,0,0,0
3547700,2014,56,"2,8",37,"1,8",19,"0,9"
3547809,2014,1548,"2,3",698,1,850,"1,2"
3547908,2014,12,"1,9",12,"1,9",0,0
3548005,2014,0,0,0,0,0,0
3548054,2014,0,0,0,0,0,0
3548104,2014,0,0,0,0,0,0
3548203,2014,0,0,0,0,0,0
3548302,2014,0,0,0,0,0,0
3548401,2014,0,0,0,0,0,0
3548500,2014,1662,"3,9",800,"1,9",862,2
3548609,2014,40,"3,8",26,"2,5",14,"1,3"
3548708,2014,1534,2,566,"0,7",968,"1,2"
3548807,2014,560,"3,7",182,"1,2",378,"2,5"
3548906,2014,419,"1,8",204,"0,9",215,"0,9"
3549003,2014,0,0,0,0,0,0
3549102,2014,198,"2,3",94,"1,1",104,"1,2"
3549201,2014,0,0,0,0,0,0
3549250,2014,0,0,0,0,0,0
3549300,2014,0,0,0,0,0,0
3549409,2014,115,"2,4",68,"1,4",47,1
3549508,2014,0,0,0,0,0,0
3549607,2014,0,0,0,0,0,0
3549706,2014,145,"2,8",89,"1,7",56,"1,1"
3549805,2014,1784,"4,2",997,"2,3",787,"1,8"
3549904,2014,1502,"2,3",834,"1,3",668,1
3549953,2014,0,0,0,0,0,0
3550001,2014,26,"2,5",11,"1,1",15,"1,4"
3550100,2014,43,"1,1",36,"0,9",7,"0,2"
3550209,2014,25,"0,8",25,"0,8",0,0
3550308,2014,29327,"2,5",15084,"1,3",14243,"1,2"
3550407,2014,62,"1,9",37,"1,1",25,"0,8"
3550506,2014,0,0,0,0,0,0
3550605,2014,103,"1,2",54,"0,7",49,"0,6"
3550704,2014,101,"1,3",93,"1,2",8,"0,1"
3550803,2014,30,"2,5",26,"2,2",4,"0,3"
3550902,2014,40,"2,8",32,"2,2",8,"0,6"
3551009,2014,287,"0,8",170,"0,5",117,"0,3"
3551108,2014,0,0,0,0,0,0
3551207,2014,0,0,0,0,0,0
3551306,2014,0,0,0,0,0,0
3551405,2014,0,0,0,0,0,0
3551504,2014,58,"1,4",43,1,15,"0,4"
3551603,2014,49,"1,8",33,"1,2",16,"0,6"
3551702,2014,157,"1,4",64,"0,6",93,"0,8"
3551801,2014,0,0,0,0,0,0
3551900,2014,0,0,0,0,0,0
3552007,2014,3,"0,5",3,"0,5",0,0
3552106,2014,62,"1,6",54,"1,4",8,"0,2"
3552205,2014,2223,"3,6",1516,"2,5",707,"1,1"
3552304,2014,20,"2,6",20,"2,6",0,0
3552403,2014,189,"0,7",172,"0,7",17,"0,1"
3552502,2014,173,"0,6",88,"0,3",85,"0,3"
3552551,2014,0,0,0,0,0,0
3552601,2014,30,"2,6",9,"0,8",21,"1,8"
3552700,2014,35,"2,3",22,"1,4",13,"0,9"
3552809,2014,570,"2,2",339,"1,3",231,"0,9"
3552908,2014,0,0,0,0,0,0
3553005,2014,29,"2,4",24,2,5,"0,4"
3553104,2014,0,0,0,0,0,0
3553203,2014,4,"0,6",4,"0,6",0,0
3553302,2014,36,"1,6",25,"1,1",11,"0,5"
3553401,2014,72,"2,9",36,"1,5",36,"1,5"
3553500,2014,0,0,0,0,0,0
3553609,2014,24,"1,9",18,"1,4",6,"0,5"
3553658,2014,0,0,0,0,0,0
3553708,2014,124,"2,3",73,"1,3",51,"0,9"
3553807,2014,53,"2,3",32,"1,4",21,"0,9"
3553856,2014,0,0,0,0,0,0
3553906,2014,0,0,0,0,0,0
3553955,2014,0,0,0,0,0,0
3554003,2014,205,"1,8",85,"0,8",120,"1,1"
3554102,2014,467,"1,6",325,"1,1",142,"0,5"
3554201,2014,0,0,0,0,0,0
3554300,2014,58,"2,7",52,"2,4",6,"0,3"
3554409,2014,34,"3,9",30,"3,4",4,"0,5"
3554508,2014,69,"1,8",42,"1,1",27,"0,7"
3554607,2014,0,0,0,0,0,0
3554656,2014,0,0,0,0,0,0
3554706,2014,20,"2,1",13,"1,4",7,"0,7"
3554755,2014,0,0,0,0,0,0
3554805,2014,41,1,0,0,41,1
3554904,2014,0,0,0,0,0,0
3554953,2014,0,0,0,0,0,0
3555000,2014,864,"13,7",791,"12,5",73,"1,2"
3555109,2014,48,"3,3",30,2,18,"1,2"
3555208,2014,0,0,0,0,0,0
3555307,2014,0,0,0,0,0,0
3555356,2014,0,0,0,0,0,0
3555406,2014,76,"0,9",67,"0,8",9,"0,1"
3555505,2014,0,0,0,0,0,0
3555604,2014,0,0,0,0,0,0
3555703,2014,0,0,0,0,0,0
3555802,2014,26,3,24,"2,7",2,"0,2"
3555901,2014,0,0,0,0,0,0
3556008,2014,34,"2,6",13,1,21,"1,6"
3556107,2014,0,0,0,0,0,0
3556206,2014,169,"1,5",63,"0,5",106,"0,9"
3556305,2014,55,"2,4",31,"1,3",24,1
3556354,2014,0,0,0,0,0,0
3556404,2014,77,"1,9",47,"1,2",30,"0,7"
3556453,2014,0,0,0,0,0,0
3556503,2014,29,"0,3",27,"0,2",2,0
3556602,2014,0,0,0,0,0,0
3556701,2014,6,"0,1",4,"0,1",2,0
3556800,2014,48,"2,7",30,"1,7",18,1
3556909,2014,9,"1,2",9,"1,2",0,0
3556958,2014,0,0,0,0,0,0
3557006,2014,150,"1,3",88,"0,8",62,"0,5"
3557105,2014,238,"2,7",123,"1,4",115,"1,3"
3557154,2014,0,0,0,0,0,0
3557204,2014,50,"4,1",30,"2,5",20,"1,6"
3557303,2014,0,0,0,0,0,0
3500105,2015,279,"8,2",240,"7,1",39,"1,2"
3500204,2015,0,0,0,0,0,0
3500303,2015,0,0,0,0,0,0
3500402,2015,0,0,0,0,0,0
3500501,2015,42,"2,4",30,"1,7",12,"0,7"
3500550,2015,0,0,0,0,0,0
3500600,2015,4,"1,4",4,"1,4",0,0
3500709,2015,60,"1,7",38,"1,1",22,"0,6"
3500758,2015,0,0,0,0,0,0
3500808,2015,0,0,0,0,0,0
3500907,2015,0,0,0,0,0,0
3501004,2015,31,2,25,"1,6",6,"0,4"
3501103,2015,22,"5,4",19,"4,7",3,"0,7"
3501152,2015,0,0,0,0,0,0
3501202,2015,0,0,0,0,0,0
3501301,2015,20,"0,8",18,"0,8",2,"0,1"
3501400,2015,0,0,0,0,0,0
3501509,2015,0,0,0,0,0,0
3501608,2015,698,"3,1",343,"1,5",355,"1,6"
3501707,2015,206,"5,5",206,"5,5",0,0
3501806,2015,0,0,0,0,0,0
3501905,2015,357,"5,3",242,"3,6",115,"1,7"
3502002,2015,0,0,0,0,0,0
3502101,2015,136,"2,4",110,2,26,"0,5"
3502200,2015,57,"2,4",54,"2,3",3,"0,1"
3502309,2015,0,0,0,0,0,0
3502408,2015,0,0,0,0,0,0
3502507,2015,104,"2,9",70,2,34,1
3502606,2015,21,"4,9",20,"4,7",1,"0,2"
3502705,2015,51,"2,1",45,"1,8",6,"0,2"
3502754,2015,0,0,0,0,0,0
3502804,2015,635,"3,4",478,"2,6",157,"0,8"
3502903,2015,288,"9,6",0,0,288,"9,6"
3503000,2015,0,0,0,0,0,0
3503109,2015,16,"2,6",16,"2,6",0,0
3503158,2015,0,0,0,0,0,0
3503208,2015,510,"2,3",199,"0,9",311,"1,4"
3503307,2015,567,"4,5",307,"2,5",260,"2,1"
3503356,2015,0,0,0,0,0,0
3503406,2015,28,"3,5",17,"2,1",11,"1,4"
3503505,2015,0,0,0,0,0,0
3503604,2015,0,0,0,0,0,0
3503703,2015,25,"2,8",4,"0,4",21,"2,3"
3503802,2015,12,"0,2",0,0,12,"0,2"
3503901,2015,82,1,15,"0,2",67,"0,8"
3503950,2015,0,0,0,0,0,0
3504008,2015,290,"2,9",179,"1,8",111,"1,1"
3504107,2015,192,"1,4",55,"0,4",137,1
3504206,2015,51,"3,6",30,"2,1",21,"1,5"
3504305,2015,0,0,0,0,0,0
3504404,2015,0,0,0,0,0,0
3504503,2015,153,"1,8",95,"1,1",58,"0,7"
3504602,2015,0,0,0,0,0,0
3504701,2015,0,0,0,0,0,0
3504800,2015,0,0,0,0,0,0
3504909,2015,15,"1,4",15,"1,4",0,0
3505005,2015,0,0,0,0,0,0
3505104,2015,0,0,0,0,0,0
3505203,2015,68,"2,1",52,"1,6",16,"0,5"
3505302,2015,101,"2,9",68,"1,9",33,"0,9"
3505351,2015,0,0,0,0,0,0
3505401,2015,0,0,0,0,0,0
3505500,2015,604,"5,2",501,"4,3",103,"0,9"
3505609,2015,0,0,0,0,0,0
3505708,2015,519,"2,1",371,"1,5",148,"0,6"
3505807,2015,35,"1,7",28,"1,4",7,"0,3"
3505906,2015,139,"2,4",94,"1,6",45,"0,8"
3506003,2015,1008,"2,8",638,"1,8",370,1
3506102,2015,129,"1,7",81,"1,1",48,"0,6"
3506201,2015,0,0,0,0,0,0
3506300,2015,50,"4,6",20,"1,9",30,"2,8"
3506359,2015,49,"0,9",49,"0,9",0,0
3506409,2015,36,"4,8",36,"4,8",0,0
3506508,2015,146,"1,3",66,"0,6",80,"0,7"
3506607,2015,0,0,0,0,0,0
3506706,2015,15,"1,1",13,"0,9",2,"0,1"
3506805,2015,35,3,30,"2,6",5,"0,4"
3506904,2015,0,0,0,0,0,0
3507001,2015,55,1,36,"0,7",19,"0,4"
3507100,2015,11,"0,5",11,"0,5",0,0
3507159,2015,0,0,0,0,0,0
3507209,2015,0,0,0,0,0,0
3507308,2015,0,0,0,0,0,0
3507407,2015,26,"1,7",16,"1,1",10,"0,7"
3507456,2015,0,0,0,0,0,0
3507506,2015,742,"5,5",542,4,200,"1,5"
3507605,2015,334,"2,1",208,"1,3",126,"0,8"
3507704,2015,0,0,0,0,0,0
3507753,2015,0,0,0,0,0,0
3507803,2015,0,0,0,0,0,0
3507902,2015,41,"1,8",35,"1,5",6,"0,3"
3508009,2015,0,0,0,0,0,0
3508108,2015,42,"2,6",22,"1,4",20,"1,2"
3508207,2015,0,0,0,0,0,0
3508306,2015,0,0,0,0,0,0
3508405,2015,13,"0,3",9,"0,2",4,"0,1"
3508504,2015,151,"1,7",73,"0,8",78,"0,9"
3508603,2015,47,"1,5",40,"1,3",7,"0,2"
3508702,2015,62,"3,3",62,"3,3",0,0
3508801,2015,58,"3,4",47,"2,8",11,"0,6"
3508900,2015,0,0,0,0,0,0
3509007,2015,117,"1,2",58,"0,6",59,"0,6"
3509106,2015,0,0,0,0,0,0
3509205,2015,171,"2,4",71,1,100,"1,4"
3509254,2015,8,"0,3",8,"0,3",0,0
3509304,2015,32,"3,2",26,"2,6",6,"0,6"
3509403,2015,73,3,55,"2,2",18,"0,7"
3509452,2015,0,0,0,0,0,0
3509502,2015,2957,"2,6",1395,"1,2",1562,"1,4"
3509601,2015,56,"0,7",56,"0,7",0,0
3509700,2015,242,"4,9",195,4,47,1
3509809,2015,0,0,0,0,0,0
3509908,2015,0,0,0,0,0,0
3509957,2015,0,0,0,0,0,0
3510005,2015,30,1,25,"0,8",5,"0,2"
3510104,2015,0,0,0,0,0,0
3510153,2015,0,0,0,0,0,0
3510203,2015,67,"1,5",49,"1,1",18,"0,4"
3510302,2015,0,0,0,0,0,0
3510401,2015,96,"1,9",46,"0,9",50,1
3510500,2015,157,"1,4",102,"0,9",55,"0,5"
3510609,2015,370,1,280,"0,7",90,"0,2"
3510708,2015,31,"2,6",14,"1,2",17,"1,4"
3510807,2015,372,"12,9",355,"12,3",17,"0,6"
3510906,2015,0,0,0,0,0,0
3511003,2015,31,"1,6",30,"1,5",1,"0,1"
3511102,2015,534,"4,6",375,"3,3",159,"1,4"
3511201,2015,0,0,0,0,0,0
3511300,2015,30,"3,6",0,0,30,"3,6"
3511409,2015,52,"2,8",34,"1,8",18,1
3511508,2015,43,1,31,"0,7",12,"0,3"
3511607,2015,30,"1,8",17,1,13,"0,8"
3511706,2015,33,"2,1",26,"1,6",7,"0,4"
3511904,2015,30,"3,9",20,"2,6",10,"1,3"
3512001,2015,47,"2,7",35,2,12,"0,7"
3512100,2015,30,5,20,"3,3",10,"1,7"
3512209,2015,52,2,41,"1,6",11,"0,4"
3512308,2015,32,"1,9",32,"1,9",0,0
3512407,2015,0,0,0,0,0,0
3512506,2015,0,0,0,0,0,0
3512605,2015,0,0,0,0,0,0
3512704,2015,0,0,0,0,0,0
3512803,2015,90,"1,4",63,1,27,"0,4"
3512902,2015,0,0,0,0,0,0
3513009,2015,289,"1,3",111,"0,5",178,"0,8"
3513108,2015,15,"0,5",13,"0,4",2,"0,1"
3513207,2015,0,0,0,0,0,0
3513306,2015,0,0,0,0,0,0
3513405,2015,120,"1,5",77,1,43,"0,5"
3513504,2015,138,"1,1",134,"1,1",4,0
3513603,2015,40,"1,8",25,"1,2",15,"0,7"
3513702,2015,40,"1,3",25,"0,8",15,"0,5"
3513801,2015,635,"1,6",566,"1,4",69,"0,2"
3513850,2015,0,0,0,0,0,0
3513900,2015,192,"17,4",192,"17,4",0,0
3514007,2015,0,0,0,0,0,0
3514106,2015,67,"2,6",47,"1,8",20,"0,8"
3514205,2015,0,0,0,0,0,0
3514304,2015,19,"2,2",16,"1,9",3,"0,4"
3514403,2015,143,"3,2",108,"2,4",35,"0,8"
3514502,2015,87,"7,2",77,"6,4",10,"0,8"
3514601,2015,0,0,0,0,0,0
3514700,2015,0,0,0,0,0,0
3514809,2015,2,"0,1",2,"0,1",0,0
3514908,2015,6,"0,4",6,"0,4",0,0
3514924,2015,0,0,0,0,0,0
3514957,2015,0,0,0,0,0,0
3515004,2015,81,"0,3",76,"0,3",5,0
3515103,2015,16,"0,2",16,"0,2",0,0
3515129,2015,0,0,0,0,0,0
3515152,2015,0,0,0,0,0,0
3515186,2015,458,"10,8",369,"8,7",89,"2,1"
3515194,2015,0,0,0,0,0,0
3515202,2015,50,"6,1",30,"3,7",20,"2,5"
3515301,2015,0,0,0,0,0,0
3515350,2015,0,0,0,0,0,0
3515400,2015,20,"1,3",12,"0,8",8,"0,5"
3515509,2015,180,"2,7",84,"1,3",96,"1,5"
3515608,2015,0,0,0,0,0,0
3515657,2015,0,0,0,0,0,0
3515707,2015,191,"1,1",191,"1,1",0,0
3515806,2015,0,0,0,0,0,0
3515905,2015,0,0,0,0,0,0
3516002,2015,47,"3,8",30,"2,4",17,"1,4"
3516101,2015,0,0,0,0,0,0
3516200,2015,739,"2,2",487,"1,5",252,"0,8"
3516309,2015,144,"0,9",95,"0,6",49,"0,3"
3516408,2015,396,"2,8",314,"2,2",82,"0,6"
3516507,2015,0,0,0,0,0,0
3516606,2015,45,"6,7",24,"3,6",21,"3,1"
3516705,2015,377,"8,8",332,"7,8",45,"1,1"
3516804,2015,0,0,0,0,0,0
3516853,2015,0,0,0,0,0,0
3516903,2015,32,3,8,"0,7",24,"2,2"
3517000,2015,48,"4,4",36,"3,3",12,"1,1"
3517109,2015,0,0,0,0,0,0
3517208,2015,0,0,0,0,0,0
3517307,2015,0,0,0,0,0,0
3517406,2015,60,"1,6",42,"1,1",18,"0,5"
3517505,2015,0,0,0,0,0,0
3517604,2015,19,"1,1",19,"1,1",0,0
3517703,2015,30,"1,5",22,"1,1",8,"0,4"
3517802,2015,27,"3,2",20,"2,4",7,"0,8"
3517901,2015,0,0,0,0,0,0
3518008,2015,0,0,0,0,0,0
3518107,2015,0,0,0,0,0,0
3518206,2015,74,"2,4",30,1,44,"1,4"
3518305,2015,35,"1,3",29,1,6,"0,2"
3518404,2015,278,"2,4",162,"1,4",116,1
3518503,2015,0,0,0,0,0,0
3518602,2015,72,"1,9",65,"1,7",7,"0,2"
3518701,2015,321,"1,1",234,"0,8",87,"0,3"
3518800,2015,1847,"1,4",1429,"1,1",418,"0,3"
3518859,2015,0,0,0,0,0,0
3518909,2015,0,0,0,0,0,0
3519006,2015,51,"5,7",51,"5,7",0,0
3519055,2015,0,0,0,0,0,0
3519071,2015,91,"0,4",62,"0,3",29,"0,1"
3519105,2015,27,"2,5",25,"2,3",2,"0,2"
3519204,2015,19,3,15,"2,4",4,"0,6"
3519253,2015,0,0,0,0,0,0
3519303,2015,32,1,32,1,0,0
3519402,2015,25,"2,2",8,"0,7",17,"1,5"
3519501,2015,0,0,0,0,0,0
3519600,2015,99,"1,8",46,"0,8",53,"0,9"
3519709,2015,67,"0,9",63,"0,9",4,"0,1"
3519808,2015,0,0,0,0,0,0
3519907,2015,20,"2,6",20,"2,6",0,0
3520004,2015,63,"2,7",55,"2,3",8,"0,3"
3520103,2015,60,"2,1",32,"1,1",28,1
3520202,2015,15,"1,7",15,"1,7",0,0
3520301,2015,13,"0,4",13,"0,4",0,0
3520400,2015,49,"1,6",46,"1,5",3,"0,1"
3520426,2015,0,0,0,0,0,0
3520442,2015,116,"4,6",74,"2,9",42,"1,6"
3520509,2015,378,"1,7",268,"1,2",110,"0,5"
3520608,2015,0,0,0,0,0,0
3520707,2015,46,"11,9",4,1,42,"10,9"
3520806,2015,0,0,0,0,0,0
3520905,2015,49,"3,5",29,"2,1",20,"1,4"
3521002,2015,15,"0,5",15,"0,5",0,0
3521101,2015,0,0,0,0,0,0
3521150,2015,0,0,0,0,0,0
3521200,2015,0,0,0,0,0,0
3521309,2015,49,"3,3",39,"2,6",10,"0,7"
3521408,2015,0,0,0,0,0,0
3521507,2015,0,0,0,0,0,0
3521606,2015,0,0,0,0,0,0
3521705,2015,35,2,35,2,0,0
3521804,2015,39,"1,5",36,"1,4",3,"0,1"
3521903,2015,30,"2,1",13,"0,9",17,"1,2"
3522000,2015,0,0,0,0,0,0
3522109,2015,77,"0,8",77,"0,8",0,0
3522158,2015,0,0,0,0,0,0
3522208,2015,501,"3,1",196,"1,2",305,"1,9"
3522307,2015,122,"0,8",100,"0,7",22,"0,1"
3522406,2015,164,"1,8",122,"1,4",42,"0,5"
3522505,2015,265,"1,2",205,"0,9",60,"0,3"
3522604,2015,1284,"18,3",749,"10,6",535,"7,6"
3522653,2015,0,0,0,0,0,0
3522703,2015,76,"1,9",45,"1,1",31,"0,8"
3522802,2015,46,"3,2",27,"1,8",19,"1,3"
3522901,2015,40,"3,1",33,"2,5",7,"0,5"
3523008,2015,0,0,0,0,0,0
3523107,2015,224,"0,6",224,"0,6",0,0
3523206,2015,93,"1,9",78,"1,6",15,"0,3"
3523305,2015,0,0,0,0,0,0
3523404,2015,119,"1,1",60,"0,5",59,"0,5"
3523503,2015,14,"0,7",7,"0,4",7,"0,4"
3523602,2015,8,"0,5",8,"0,5",0,0
3523701,2015,0,0,0,0,0,0
3523800,2015,0,0,0,0,0,0
3523909,2015,426,"2,6",391,"2,4",35,"0,2"
3524006,2015,86,"1,6",48,"0,9",38,"0,7"
3524105,2015,121,"3,1",55,"1,4",66,"1,7"
3524204,2015,17,"2,6",17,"2,6",0,0
3524303,2015,172,"2,4",56,"0,8",116,"1,6"
3524402,2015,440,2,211,1,229,1
3524501,2015,191,"30,1",150,"23,6",41,"6,5"
3524600,2015,0,0,0,0,0,0
3524709,2015,80,"1,6",78,"1,5",2,0
3524808,2015,165,"3,5",112,"2,4",53,"1,1"
3524907,2015,0,0,0,0,0,0
3525003,2015,40,"0,3",26,"0,2",14,"0,1"
3525102,2015,0,0,0,0,0,0
3525201,2015,33,"1,2",12,"0,4",21,"0,8"
3525300,2015,860,"6,1",705,5,155,"1,1"
3525409,2015,0,0,0,0,0,0
3525508,2015,24,2,17,"1,4",7,"0,6"
3525607,2015,0,0,0,0,0,0
3525706,2015,61,"1,8",29,"0,8",32,"0,9"
3525805,2015,0,0,0,0,0,0
3525854,2015,0,0,0,0,0,0
3525904,2015,800,2,376,1,424,"1,1"
3526001,2015,52,"2,7",26,"1,3",26,"1,3"
3526100,2015,15,"0,8",15,"0,8",0,0
3526209,2015,9,"0,3",0,0,9,"0,3"
3526308,2015,0,0,0,0,0,0
3526407,2015,47,"1,8",32,"1,2",15,"0,6"
3526506,2015,0,0,0,0,0,0
3526605,2015,0,0,0,0,0,0
3526704,2015,124,"1,3",76,"0,8",48,"0,5"
3526803,2015,81,"1,3",54,"0,8",27,"0,4"
3526902,2015,404,"1,4",200,"0,7",204,"0,7"
3527009,2015,0,0,0,0,0,0
3527108,2015,444,6,349,"4,7",95,"1,3"
3527207,2015,170,2,82,1,88,1
3527256,2015,0,0,0,0,0,0
3527306,2015,41,"0,9",34,"0,8",7,"0,2"
3527405,2015,25,"1,2",15,"0,7",10,"0,5"
3527504,2015,0,0,0,0,0,0
3527603,2015,0,0,0,0,0,0
3527702,2015,32,"5,9",15,"2,8",17,"3,2"
3527801,2015,0,0,0,0,0,0
3527900,2015,0,0,0,0,0,0
3528007,2015,31,"1,9",18,"1,1",13,"0,8"
3528106,2015,24,"3,1",13,"1,7",11,"1,4"
3528205,2015,0,0,0,0,0,0
3528304,2015,0,0,0,0,0,0
3528403,2015,0,0,0,0,0,0
3528502,2015,47,"0,5",47,"0,5",0,0
3528601,2015,0,0,0,0,0,0
3528700,2015,0,0,0,0,0,0
3528809,2015,26,"1,9",26,"1,9",0,0
3528858,2015,0,0,0,0,0,0
3528908,2015,0,0,0,0,0,0
3529005,2015,854,"3,8",709,"3,2",145,"0,6"
3529104,2015,0,0,0,0,0,0
3529203,2015,51,2,43,"1,7",8,"0,3"
3529302,2015,162,"2,1",96,"1,2",66,"0,8"
3529401,2015,415,"0,9",272,"0,6",143,"0,3"
3529500,2015,0,0,0,0,0,0
3529609,2015,0,0,0,0,0,0
3529658,2015,0,0,0,0,0,0
3529708,2015,66,"3,1",47,"2,2",19,"0,9"
3529807,2015,0,0,0,0,0,0
3529906,2015,0,0,0,0,0,0
3530003,2015,0,0,0,0,0,0
3530102,2015,90,"3,2",90,"3,2",0,0
3530201,2015,0,0,0,0,0,0
3530300,2015,81,"1,4",29,"0,5",52,"0,9"
3530409,2015,0,0,0,0,0,0
3530508,2015,135,2,86,"1,3",49,"0,7"
3530607,2015,828,2,650,"1,6",178,"0,4"
3530706,2015,333,"2,3",154,"1,1",179,"1,3"
3530805,2015,241,"2,7",133,"1,5",108,"1,2"
3530904,2015,0,0,0,0,0,0
3531001,2015,0,0,0,0,0,0
3531100,2015,44,"0,9",44,"0,9",0,0
3531209,2015,0,0,0,0,0,0
3531308,2015,109,"2,3",58,"1,2",51,"1,1"
3531407,2015,80,"3,5",31,"1,4",49,"2,2"
3531506,2015,70,"3,8",51,"2,7",19,1
3531605,2015,0,0,0,0,0,0
3531704,2015,0,0,0,0,0,0
3531803,2015,36,"0,7",29,"0,5",7,"0,1"
3531902,2015,45,"1,5",31,1,14,"0,5"
3532009,2015,23,"1,8",13,1,10,"0,8"
3532058,2015,0,0,0,0,0,0
3532108,2015,0,0,0,0,0,0
3532157,2015,0,0,0,0,0,0
3532207,2015,0,0,0,0,0,0
3532306,2015,0,0,0,0,0,0
3532405,2015,24,"1,4",24,"1,4",0,0
3532504,2015,35,4,11,"1,3",24,"2,8"
3532603,2015,129,"11,9",35,"3,2",94,"8,7"
3532702,2015,0,0,0,0,0,0
3532801,2015,0,0,0,0,0,0
3532827,2015,0,0,0,0,0,0
3532843,2015,0,0,0,0,0,0
3532868,2015,0,0,0,0,0,0
3532900,2015,12,"1,2",7,"0,7",5,"0,5"
3533007,2015,193,"9,6",19,"0,9",174,"8,7"
3533106,2015,0,0,0,0,0,0
3533205,2015,0,0,0,0,0,0
3533254,2015,0,0,0,0,0,0
3533304,2015,0,0,0,0,0,0
3533403,2015,53,1,53,1,0,0
3533502,2015,105,"2,8",35,"0,9",70,"1,8"
3533601,2015,0,0,0,0,0,0
3533700,2015,0,0,0,0,0,0
3533809,2015,0,0,0,0,0,0
3533908,2015,99,"1,9",63,"1,2",36,"0,7"
3534005,2015,0,0,0,0,0,0
3534104,2015,0,0,0,0,0,0
3534203,2015,0,0,0,0,0,0
3534302,2015,98,"2,4",59,"1,4",39,"0,9"
3534401,2015,1008,"1,5",605,"0,9",403,"0,6"
3534500,2015,0,0,0,0,0,0
3534609,2015,90,"2,9",59,"1,9",31,1
3534708,2015,328,"3,1",143,"1,3",185,"1,7"
3534757,2015,39,"4,3",10,"1,1",29,"3,2"
3534807,2015,0,0,0,0,0,0
3534906,2015,37,"2,8",32,"2,4",5,"0,4"
3535002,2015,0,0,0,0,0,0
3535101,2015,0,0,0,0,0,0
3535200,2015,24,"2,6",10,"1,1",14,"1,5"
3535309,2015,68,"3,2",44,"2,1",24,"1,1"
3535408,2015,36,"2,4",35,"2,3",1,"0,1"
3535507,2015,97,"2,2",78,"1,8",19,"0,4"
3535606,2015,0,0,0,0,0,0
3535705,2015,0,0,0,0,0,0
3535804,2015,30,"1,6",30,"1,6",0,0
3535903,2015,0,0,0,0,0,0
3536000,2015,32,3,26,"2,4",6,"0,6"
3536109,2015,0,0,0,0,0,0
3536208,2015,151,8,151,8,0,0
3536257,2015,0,0,0,0,0,0
3536307,2015,35,"2,5",23,"1,7",12,"0,9"
3536406,2015,0,0,0,0,0,0
3536505,2015,85,"0,9",85,"0,9",0,0
3536570,2015,0,0,0,0,0,0
3536604,2015,24,"2,8",9,"1,1",15,"1,8"
3536703,2015,72,"1,7",52,"1,2",20,"0,5"
3536802,2015,0,0,0,0,0,0
3536901,2015,0,0,0,0,0,0
3537008,2015,53,"3,3",33,"2,1",20,"1,2"
3537107,2015,98,"2,2",98,"2,2",0,0
3537156,2015,0,0,0,0,0,0
3537206,2015,0,0,0,0,0,0
3537305,2015,238,4,168,"2,8",70,"1,2"
3537404,2015,104,"4,1",71,"2,8",33,"1,3"
3537503,2015,0,0,0,0,0,0
3537602,2015,0,0,0,0,0,0
3537701,2015,0,0,0,0,0,0
3537800,2015,521,"9,9",471,"8,9",50,"0,9"
3537909,2015,35,"1,3",27,1,8,"0,3"
3538006,2015,201,"1,3",127,"0,8",74,"0,5"
3538105,2015,0,0,0,0,0,0
3538204,2015,0,0,0,0,0,0
3538303,2015,0,0,0,0,0,0
3538501,2015,0,0,0,0,0,0
3538600,2015,37,"1,4",29,"1,1",8,"0,3"
3538709,2015,761,2,309,"0,8",452,"1,2"
3538808,2015,73,"2,6",55,"1,9",18,"0,6"
3538907,2015,299,"12,9",289,"12,5",10,"0,4"
3539004,2015,41,"3,8",9,"0,8",32,3
3539103,2015,0,0,0,0,0,0
3539202,2015,0,0,0,0,0,0
3539301,2015,94,"1,3",57,"0,8",37,"0,5"
3539400,2015,30,"2,4",26,"2,1",4,"0,3"
3539509,2015,50,"1,4",32,"0,9",18,"0,5"
3539608,2015,0,0,0,0,0,0
3539707,2015,0,0,0,0,0,0
3539806,2015,33,"0,3",33,"0,3",0,0
3539905,2015,0,0,0,0,0,0
3540002,2015,42,2,36,"1,7",6,"0,3"
3540101,2015,0,0,0,0,0,0
3540200,2015,45,1,29,"0,6",16,"0,4"
3540259,2015,0,0,0,0,0,0
3540309,2015,0,0,0,0,0,0
3540408,2015,18,"4,4",8,2,10,"2,4"
3540507,2015,0,0,0,0,0,0
3540606,2015,51,1,39,"0,8",12,"0,2"
3540705,2015,61,"1,2",33,"0,6",28,"0,5"
3540754,2015,0,0,0,0,0,0
3540804,2015,31,"1,9",28,"1,7",3,"0,2"
3540853,2015,0,0,0,0,0,0
3540903,2015,0,0,0,0,0,0
3541000,2015,194,"0,7",118,"0,4",76,"0,3"
3541059,2015,0,0,0,0,0,0
3541109,2015,0,0,0,0,0,0
3541208,2015,51,"3,7",40,"2,9",11,"0,8"
3541307,2015,78,"1,9",68,"1,6",10,"0,2"
3541406,2015,1559,"7,3",1088,"5,1",471,"2,2"
3541505,2015,97,"2,6",75,2,22,"0,6"
3541604,2015,58,"1,5",58,"1,5",0,0
3541653,2015,0,0,0,0,0,0
3541703,2015,0,0,0,0,0,0
3541802,2015,0,0,0,0,0,0
3541901,2015,19,"1,6",19,"1,6",0,0
3542008,2015,0,0,0,0,0,0
3542107,2015,0,0,0,0,0,0
3542206,2015,98,"3,4",70,"2,4",28,1
3542305,2015,0,0,0,0,0,0
3542404,2015,24,"1,3",17,"0,9",7,"0,4"
3542503,2015,0,0,0,0,0,0
3542602,2015,110,2,68,"1,3",42,"0,8"
3542701,2015,0,0,0,0,0,0
3542800,2015,0,0,0,0,0,0
3542909,2015,17,"1,4",11,"0,9",6,"0,5"
3543006,2015,36,2,35,2,1,"0,1"
3543105,2015,0,0,0,0,0,0
3543204,2015,0,0,0,0,0,0
3543238,2015,0,0,0,0,0,0
3543253,2015,0,0,0,0,0,0
3543303,2015,164,"1,4",50,"0,4",114,1
3543402,2015,2044,"3,2",1399,"2,2",645,1
3543501,2015,0,0,0,0,0,0
3543600,2015,0,0,0,0,0,0
3543709,2015,0,0,0,0,0,0
3543808,2015,33,"3,4",25,"2,5",8,"0,8"
3543907,2015,482,"2,5",278,"1,4",204,"1,1"
3544004,2015,53,"1,6",38,"1,2",15,"0,5"
3544103,2015,0,0,0,0,0,0
3544202,2015,36,"3,3",7,"0,6",29,"2,6"
3544251,2015,57,3,57,3,0,0
3544301,2015,14,"1,4",14,"1,4",0,0
3544400,2015,0,0,0,0,0,0
3544509,2015,0,0,0,0,0,0
3544608,2015,0,0,0,0,0,0
3544707,2015,0,0,0,0,0,0
3544806,2015,0,0,0,0,0,0
3544905,2015,29,"2,6",19,"1,7",10,"0,9"
3545001,2015,19,"1,2",17,1,2,"0,1"
3545100,2015,0,0,0,0,0,0
3545159,2015,0,0,0,0,0,0
3545209,2015,123,"1,1",70,"0,6",53,"0,5"
3545308,2015,1026,"24,3",1000,"23,7",26,"0,6"
3545407,2015,34,"3,8",22,"2,5",12,"1,3"
3545506,2015,0,0,0,0,0,0
3545605,2015,23,"1,6",7,"0,5",16,"1,1"
3545704,2015,0,0,0,0,0,0
3545803,2015,149,"0,8",84,"0,5",65,"0,4"
3546009,2015,0,0,0,0,0,0
3546108,2015,0,0,0,0,0,0
3546207,2015,0,0,0,0,0,0
3546256,2015,0,0,0,0,0,0
3546306,2015,46,"1,4",25,"0,8",21,"0,7"
3546405,2015,100,"2,2",65,"1,4",35,"0,8"
3546504,2015,0,0,0,0,0,0
3546603,2015,76,"2,5",33,"1,1",43,"1,4"
3546702,2015,0,0,0,0,0,0
3546801,2015,101,"1,9",82,"1,6",19,"0,4"
3546900,2015,0,0,0,0,0,0
3547007,2015,6,1,6,1,0,0
3547106,2015,0,0,0,0,0,0
3547205,2015,0,0,0,0,0,0
3547304,2015,35,"0,3",35,"0,3",0,0
3547403,2015,0,0,0,0,0,0
3547502,2015,299,"11,3",276,"10,4",23,"0,9"
3547601,2015,30,"1,2",18,"0,7",12,"0,5"
3547650,2015,0,0,0,0,0,0
3547700,2015,56,"2,8",37,"1,8",19,"0,9"
3547809,2015,1245,"1,8",706,1,539,"0,8"
3547908,2015,12,"1,9",12,"1,9",0,0
3548005,2015,0,0,0,0,0,0
3548054,2015,0,0,0,0,0,0
3548104,2015,0,0,0,0,0,0
3548203,2015,0,0,0,0,0,0
3548302,2015,0,0,0,0,0,0
3548401,2015,0,0,0,0,0,0
3548500,2015,1636,"3,9",799,"1,9",837,2
3548609,2015,40,"3,8",26,"2,5",14,"1,3"
3548708,2015,1528,"1,9",569,"0,7",959,"1,2"
3548807,2015,424,"2,8",182,"1,2",242,"1,6"
3548906,2015,419,"1,8",204,"0,9",215,"0,9"
3549003,2015,0,0,0,0,0,0
3549102,2015,199,"2,3",94,"1,1",105,"1,2"
3549201,2015,0,0,0,0,0,0
3549250,2015,0,0,0,0,0,0
3549300,2015,0,0,0,0,0,0
3549409,2015,115,"2,4",68,"1,4",47,1
3549508,2015,0,0,0,0,0,0
3549607,2015,0,0,0,0,0,0
3549706,2015,145,"2,8",89,"1,7",56,"1,1"
3549805,2015,1861,"4,3",997,"2,3",864,2
3549904,2015,1421,"2,1",740,"1,1",681,1
3549953,2015,0,0,0,0,0,0
3550001,2015,26,"2,5",11,"1,1",15,"1,4"
3550100,2015,43,"1,1",36,"0,9",7,"0,2"
3550209,2015,50,"1,6",50,"1,6",0,0
3550308,2015,29392,"2,5",15698,"1,4",13694,"1,2"
3550407,2015,62,"1,9",37,"1,1",25,"0,8"
3550506,2015,0,0,0,0,0,0
3550605,2015,89,"1,1",41,"0,5",48,"0,6"
3550704,2015,101,"1,2",93,"1,2",8,"0,1"
3550803,2015,30,"2,5",26,"2,2",4,"0,3"
3550902,2015,50,"3,4",38,"2,6",12,"0,8"
3551009,2015,287,"0,8",170,"0,5",117,"0,3"
3551108,2015,0,0,0,0,0,0
3551207,2015,0,0,0,0,0,0
3551306,2015,0,0,0,0,0,0
3551405,2015,0,0,0,0,0,0
3551504,2015,58,"1,4",43,1,15,"0,4"
3551603,2015,49,"1,8",33,"1,2",16,"0,6"
3551702,2015,157,"1,3",64,"0,5",93,"0,8"
3551801,2015,0,0,0,0,0,0
3551900,2015,0,0,0,0,0,0
3552007,2015,3,"0,5",3,"0,5",0,0
3552106,2015,62,"1,6",54,"1,4",8,"0,2"
3552205,2015,1924,"3,1",1165,"1,9",759,"1,2"
3552304,2015,20,"2,6",20,"2,6",0,0
3552403,2015,189,"0,7",172,"0,7",17,"0,1"
3552502,2015,173,"0,6",84,"0,3",89,"0,3"
3552551,2015,0,0,0,0,0,0
3552601,2015,30,"2,6",9,"0,8",21,"1,8"
3552700,2015,35,"2,3",22,"1,4",13,"0,8"
3552809,2015,505,"1,9",334,"1,3",171,"0,6"
3552908,2015,0,0,0,0,0,0
3553005,2015,29,"2,4",24,2,5,"0,4"
3553104,2015,0,0,0,0,0,0
3553203,2015,4,"0,6",4,"0,6",0,0
3553302,2015,36,"1,6",25,"1,1",11,"0,5"
3553401,2015,72,"2,9",32,"1,3",40,"1,6"
3553500,2015,0,0,0,0,0,0
3553609,2015,24,"1,9",19,"1,5",5,"0,4"
3553658,2015,0,0,0,0,0,0
3553708,2015,124,"2,3",73,"1,3",51,"0,9"
3553807,2015,53,"2,3",32,"1,4",21,"0,9"
3553856,2015,0,0,0,0,0,0
3553906,2015,0,0,0,0,0,0
3553955,2015,0,0,0,0,0,0
3554003,2015,198,"1,7",85,"0,7",113,1
3554102,2015,497,"1,7",325,"1,1",172,"0,6"
3554201,2015,0,0,0,0,0,0
3554300,2015,58,"2,6",52,"2,4",6,"0,3"
3554409,2015,34,"3,9",30,"3,4",4,"0,5"
3554508,2015,69,"1,8",42,"1,1",27,"0,7"
3554607,2015,0,0,0,0,0,0
3554656,2015,0,0,0,0,0,0
3554706,2015,20,"2,1",13,"1,4",7,"0,7"
3554755,2015,0,0,0,0,0,0
3554805,2015,0,0,0,0,0,0
3554904,2015,0,0,0,0,0,0
3554953,2015,0,0,0,0,0,0
3555000,2015,864,"13,7",781,"12,4",83,"1,3"
3555109,2015,48,"3,3",30,2,18,"1,2"
3555208,2015,0,0,0,0,0,0
3555307,2015,0,0,0,0,0,0
3555356,2015,0,0,0,0,0,0
3555406,2015,79,"0,9",74,"0,9",5,"0,1"
3555505,2015,0,0,0,0,0,0
3555604,2015,0,0,0,0,0,0
3555703,2015,0,0,0,0,0,0
3555802,2015,26,3,24,"2,7",2,"0,2"
3555901,2015,0,0,0,0,0,0
3556008,2015,34,"2,6",13,1,21,"1,6"
3556107,2015,0,0,0,0,0,0
3556206,2015,169,"1,4",63,"0,5",106,"0,9"
3556305,2015,55,"2,4",31,"1,3",24,1
3556354,2015,0,0,0,0,0,0
3556404,2015,77,"1,9",47,"1,2",30,"0,7"
3556453,2015,0,0,0,0,0,0
3556503,2015,35,"0,3",27,"0,2",8,"0,1"
3556602,2015,0,0,0,0,0,0
3556701,2015,32,"0,5",20,"0,3",12,"0,2"
3556800,2015,48,"2,7",30,"1,7",18,1
3556909,2015,0,0,0,0,0,0
3556958,2015,0,0,0,0,0,0
3557006,2015,150,"1,3",88,"0,8",62,"0,5"
3557105,2015,208,"2,4",125,"1,4",83,"0,9"
3557154,2015,0,0,0,0,0,0
3557204,2015,50,"4,1",30,"2,5",20,"1,6"
3557303,2015,0,0,0,0,0,0
3500105,2016,279,"8,2",240,"7,1",39,"1,2"
3500204,2016,0,0,0,0,0,0
3500303,2016,10,"0,3",0,0,10,"0,3"
3500402,2016,0,0,0,0,0,0
3500501,2016,42,"2,3",30,"1,7",12,"0,7"
3500550,2016,0,0,0,0,0,0
3500600,2016,4,"1,3",4,"1,3",0,0
3500709,2016,60,"1,7",38,"1,1",22,"0,6"
3500758,2016,0,0,0,0,0,0
3500808,2016,0,0,0,0,0,0
3500907,2016,0,0,0,0,0,0
3501004,2016,31,2,25,"1,6",6,"0,4"
3501103,2016,22,"5,4",19,"4,7",3,"0,7"
3501152,2016,0,0,0,0,0,0
3501202,2016,0,0,0,0,0,0
3501301,2016,20,"0,8",18,"0,8",2,"0,1"
3501400,2016,0,0,0,0,0,0
3501509,2016,0,0,0,0,0,0
3501608,2016,640,"2,8",251,"1,1",389,"1,7"
3501707,2016,230,6,230,6,0,0
3501806,2016,0,0,0,0,0,0
3501905,2016,395,"5,8",242,"3,5",153,"2,2"
3502002,2016,0,0,0,0,0,0
3502101,2016,136,"2,4",110,2,26,"0,5"
3502200,2016,57,"2,4",54,"2,3",3,"0,1"
3502309,2016,0,0,0,0,0,0
3502408,2016,0,0,0,0,0,0
3502507,2016,104,"2,9",70,2,34,1
3502606,2016,21,"4,9",20,"4,7",1,"0,2"
3502705,2016,51,"2,1",45,"1,8",6,"0,2"
3502754,2016,0,0,0,0,0,0
3502804,2016,474,"2,5",328,"1,8",146,"0,8"
3502903,2016,351,"11,6",0,0,351,"11,6"
3503000,2016,0,0,0,0,0,0
3503109,2016,16,"2,6",16,"2,6",0,0
3503158,2016,0,0,0,0,0,0
3503208,2016,509,"2,3",188,"0,8",321,"1,5"
3503307,2016,557,"4,4",300,"2,4",257,2
3503356,2016,0,0,0,0,0,0
3503406,2016,28,"3,5",17,"2,1",11,"1,4"
3503505,2016,0,0,0,0,0,0
3503604,2016,0,0,0,0,0,0
3503703,2016,25,"2,8",4,"0,4",21,"2,3"
3503802,2016,12,"0,2",0,0,12,"0,2"
3503901,2016,92,"1,1",24,"0,3",68,"0,8"
3503950,2016,0,0,0,0,0,0
3504008,2016,307,"3,1",183,"1,8",124,"1,3"
3504107,2016,192,"1,4",55,"0,4",137,1
3504206,2016,51,"3,5",30,"2,1",21,"1,5"
3504305,2016,0,0,0,0,0,0
3504404,2016,0,0,0,0,0,0
3504503,2016,159,"1,9",95,"1,1",64,"0,7"
3504602,2016,0,0,0,0,0,0
3504701,2016,0,0,0,0,0,0
3504800,2016,0,0,0,0,0,0
3504909,2016,15,"1,4",15,"1,4",0,0
3505005,2016,0,0,0,0,0,0
3505104,2016,0,0,0,0,0,0
3505203,2016,68,"2,1",52,"1,6",16,"0,5"
3505302,2016,101,"2,9",68,"1,9",33,"0,9"
3505351,2016,0,0,0,0,0,0
3505401,2016,0,0,0,0,0,0
3505500,2016,581,5,464,4,117,1
3505609,2016,0,0,0,0,0,0
3505708,2016,499,2,351,"1,4",148,"0,6"
3505807,2016,35,"1,7",28,"1,4",7,"0,3"
3505906,2016,139,"2,4",94,"1,6",45,"0,8"
3506003,2016,1107,"3,1",612,"1,7",495,"1,4"
3506102,2016,129,"1,7",81,"1,1",48,"0,6"
3506201,2016,0,0,0,0,0,0
3506300,2016,50,"4,6",20,"1,9",30,"2,8"
3506359,2016,49,"0,9",49,"0,9",0,0
3506409,2016,36,"4,8",36,"4,8",0,0
3506508,2016,146,"1,3",66,"0,6",80,"0,7"
3506607,2016,0,0,0,0,0,0
3506706,2016,15,"1,1",13,"0,9",2,"0,1"
3506805,2016,35,3,29,"2,5",6,"0,5"
3506904,2016,0,0,0,0,0,0
3507001,2016,53,1,36,"0,7",17,"0,3"
3507100,2016,11,"0,5",11,"0,5",0,0
3507159,2016,0,0,0,0,0,0
3507209,2016,0,0,0,0,0,0
3507308,2016,0,0,0,0,0,0
3507407,2016,26,"1,7",16,"1,1",10,"0,7"
3507456,2016,0,0,0,0,0,0
3507506,2016,702,"5,2",502,"3,7",200,"1,5"
3507605,2016,395,"2,5",210,"1,3",185,"1,2"
3507704,2016,0,0,0,0,0,0
3507753,2016,0,0,0,0,0,0
3507803,2016,0,0,0,0,0,0
3507902,2016,41,"1,8",35,"1,5",6,"0,3"
3508009,2016,0,0,0,0,0,0
3508108,2016,42,"2,6",22,"1,4",20,"1,2"
3508207,2016,0,0,0,0,0,0
3508306,2016,0,0,0,0,0,0
3508405,2016,13,"0,3",9,"0,2",4,"0,1"
3508504,2016,151,"1,7",73,"0,8",78,"0,9"
3508603,2016,47,"1,5",40,"1,3",7,"0,2"
3508702,2016,62,"3,3",62,"3,3",0,0
3508801,2016,58,"3,4",47,"2,8",11,"0,6"
3508900,2016,0,0,0,0,0,0
3509007,2016,117,"1,2",58,"0,6",59,"0,6"
3509106,2016,0,0,0,0,0,0
3509205,2016,155,"2,1",55,"0,8",100,"1,4"
3509254,2016,0,0,0,0,0,0
3509304,2016,32,"3,2",26,"2,6",6,"0,6"
3509403,2016,73,"2,9",55,"2,2",18,"0,7"
3509452,2016,0,0,0,0,0,0
3509502,2016,2918,"2,6",1332,"1,2",1586,"1,4"
3509601,2016,56,"0,7",56,"0,7",0,0
3509700,2016,297,6,250,"5,1",47,1
3509809,2016,0,0,0,0,0,0
3509908,2016,0,0,0,0,0,0
3509957,2016,0,0,0,0,0,0
3510005,2016,30,1,25,"0,8",5,"0,2"
3510104,2016,0,0,0,0,0,0
3510153,2016,0,0,0,0,0,0
3510203,2016,67,"1,5",49,"1,1",18,"0,4"
3510302,2016,14,"0,7",14,"0,7",0,0
3510401,2016,96,"1,8",46,"0,9",50,1
3510500,2016,165,"1,5",107,1,58,"0,5"
3510609,2016,370,1,220,"0,6",150,"0,4"
3510708,2016,31,"2,6",13,"1,1",18,"1,5"
3510807,2016,372,"12,8",355,"12,2",17,"0,6"
3510906,2016,0,0,0,0,0,0
3511003,2016,31,"1,6",30,"1,5",1,"0,1"
3511102,2016,535,"4,6",374,"3,2",161,"1,4"
3511201,2016,0,0,0,0,0,0
3511300,2016,30,"3,5",0,0,30,"3,5"
3511409,2016,52,"2,8",34,"1,8",18,1
3511508,2016,37,"0,8",29,"0,7",8,"0,2"
3511607,2016,30,"1,8",17,1,13,"0,8"
3511706,2016,33,2,26,"1,6",7,"0,4"
3511904,2016,30,"3,8",20,"2,5",10,"1,3"
3512001,2016,47,"2,7",35,2,12,"0,7"
3512100,2016,20,"3,3",20,"3,3",0,0
3512209,2016,52,2,41,"1,5",11,"0,4"
3512308,2016,32,"1,9",32,"1,9",0,0
3512407,2016,0,0,0,0,0,0
3512506,2016,0,0,0,0,0,0
3512605,2016,0,0,0,0,0,0
3512704,2016,0,0,0,0,0,0
3512803,2016,90,"1,4",63,"0,9",27,"0,4"
3512902,2016,0,0,0,0,0,0
3513009,2016,177,"0,8",111,"0,5",66,"0,3"
3513108,2016,15,"0,4",13,"0,4",2,"0,1"
3513207,2016,0,0,0,0,0,0
3513306,2016,0,0,0,0,0,0
3513405,2016,120,"1,5",77,1,43,"0,5"
3513504,2016,145,"1,2",141,"1,1",4,0
3513603,2016,40,"1,8",25,"1,2",15,"0,7"
3513702,2016,40,"1,3",25,"0,8",15,"0,5"
3513801,2016,624,"1,6",555,"1,4",69,"0,2"
3513850,2016,0,0,0,0,0,0
3513900,2016,192,"17,5",192,"17,5",0,0
3514007,2016,0,0,0,0,0,0
3514106,2016,67,"2,6",47,"1,8",20,"0,8"
3514205,2016,0,0,0,0,0,0
3514304,2016,19,"2,2",16,"1,9",3,"0,4"
3514403,2016,143,"3,2",108,"2,4",35,"0,8"
3514502,2016,87,"7,2",77,"6,4",10,"0,8"
3514601,2016,0,0,0,0,0,0
3514700,2016,0,0,0,0,0,0
3514809,2016,2,"0,1",2,"0,1",0,0
3514908,2016,6,"0,4",6,"0,4",0,0
3514924,2016,0,0,0,0,0,0
3514957,2016,0,0,0,0,0,0
3515004,2016,94,"0,4",89,"0,3",5,0
3515103,2016,16,"0,2",16,"0,2",0,0
3515129,2016,0,0,0,0,0,0
3515152,2016,0,0,0,0,0,0
3515186,2016,454,"10,7",366,"8,6",88,"2,1"
3515194,2016,0,0,0,0,0,0
3515202,2016,50,"6,1",30,"3,7",20,"2,5"
3515301,2016,0,0,0,0,0,0
3515350,2016,0,0,0,0,0,0
3515400,2016,20,"1,3",12,"0,8",8,"0,5"
3515509,2016,130,2,84,"1,3",46,"0,7"
3515608,2016,0,0,0,0,0,0
3515657,2016,0,0,0,0,0,0
3515707,2016,189,1,189,1,0,0
3515806,2016,0,0,0,0,0,0
3515905,2016,0,0,0,0,0,0
3516002,2016,47,"3,8",30,"2,4",17,"1,4"
3516101,2016,0,0,0,0,0,0
3516200,2016,747,"2,2",471,"1,4",276,"0,8"
3516309,2016,147,"0,9",98,"0,6",49,"0,3"
3516408,2016,692,"4,8",610,"4,2",82,"0,6"
3516507,2016,0,0,0,0,0,0
3516606,2016,45,"6,7",24,"3,6",21,"3,1"
3516705,2016,377,"8,8",332,"7,8",45,"1,1"
3516804,2016,0,0,0,0,0,0
3516853,2016,0,0,0,0,0,0
3516903,2016,32,3,8,"0,7",24,"2,2"
3517000,2016,48,"4,4",36,"3,3",12,"1,1"
3517109,2016,0,0,0,0,0,0
3517208,2016,0,0,0,0,0,0
3517307,2016,0,0,0,0,0,0
3517406,2016,60,"1,6",42,"1,1",18,"0,5"
3517505,2016,0,0,0,0,0,0
3517604,2016,19,"1,1",19,"1,1",0,0
3517703,2016,30,"1,5",22,"1,1",8,"0,4"
3517802,2016,23,"2,7",15,"1,8",8,"0,9"
3517901,2016,0,0,0,0,0,0
3518008,2016,0,0,0,0,0,0
3518107,2016,0,0,0,0,0,0
3518206,2016,74,"2,3",30,1,44,"1,4"
3518305,2016,35,"1,3",29,1,6,"0,2"
3518404,2016,272,"2,3",162,"1,4",110,"0,9"
3518503,2016,0,0,0,0,0,0
3518602,2016,72,"1,9",65,"1,7",7,"0,2"
3518701,2016,323,"1,1",217,"0,7",106,"0,3"
3518800,2016,1909,"1,5",1453,"1,1",456,"0,4"
3518859,2016,0,0,0,0,0,0
3518909,2016,0,0,0,0,0,0
3519006,2016,58,"6,4",58,"6,4",0,0
3519055,2016,0,0,0,0,0,0
3519071,2016,91,"0,4",62,"0,3",29,"0,1"
3519105,2016,27,"2,5",25,"2,3",2,"0,2"
3519204,2016,19,3,15,"2,4",4,"0,6"
3519253,2016,0,0,0,0,0,0
3519303,2016,32,1,32,1,0,0
3519402,2016,25,"2,2",8,"0,7",17,"1,5"
3519501,2016,0,0,0,0,0,0
3519600,2016,99,"1,8",46,"0,8",53,"0,9"
3519709,2016,67,"0,9",63,"0,8",4,"0,1"
3519808,2016,0,0,0,0,0,0
3519907,2016,20,"2,6",20,"2,6",0,0
3520004,2016,63,"2,6",0,0,63,"2,6"
3520103,2016,60,"2,1",32,"1,1",28,1
3520202,2016,15,"1,6",15,"1,6",0,0
3520301,2016,13,"0,4",13,"0,4",0,0
3520400,2016,49,"1,6",46,"1,5",3,"0,1"
3520426,2016,0,0,0,0,0,0
3520442,2016,116,"4,5",74,"2,9",42,"1,6"
3520509,2016,342,"1,5",232,1,110,"0,5"
3520608,2016,0,0,0,0,0,0
3520707,2016,36,"9,3",4,1,32,"8,3"
3520806,2016,0,0,0,0,0,0
3520905,2016,49,"3,5",29,2,20,"1,4"
3521002,2016,15,"0,5",15,"0,5",0,0
3521101,2016,0,0,0,0,0,0
3521150,2016,0,0,0,0,0,0
3521200,2016,0,0,0,0,0,0
3521309,2016,49,"3,2",39,"2,6",10,"0,7"
3521408,2016,0,0,0,0,0,0
3521507,2016,0,0,0,0,0,0
3521606,2016,0,0,0,0,0,0
3521705,2016,35,2,35,2,0,0
3521804,2016,39,"1,5",36,"1,4",3,"0,1"
3521903,2016,27,"1,8",15,1,12,"0,8"
3522000,2016,0,0,0,0,0,0
3522109,2016,77,"0,8",77,"0,8",0,0
3522158,2016,0,0,0,0,0,0
3522208,2016,501,"3,1",176,"1,1",325,2
3522307,2016,122,"0,8",100,"0,6",22,"0,1"
3522406,2016,159,"1,8",117,"1,3",42,"0,5"
3522505,2016,286,"1,3",205,"0,9",81,"0,4"
3522604,2016,1046,"14,8",587,"8,3",459,"6,5"
3522653,2016,0,0,0,0,0,0
3522703,2016,76,"1,9",46,"1,1",30,"0,7"
3522802,2016,46,"3,1",27,"1,8",19,"1,3"
3522901,2016,30,"2,3",25,"1,9",5,"0,4"
3523008,2016,0,0,0,0,0,0
3523107,2016,224,"0,6",224,"0,6",0,0
3523206,2016,97,2,82,"1,7",15,"0,3"
3523305,2016,0,0,0,0,0,0
3523404,2016,119,"1,1",60,"0,5",59,"0,5"
3523503,2016,14,"0,7",7,"0,4",7,"0,4"
3523602,2016,25,"1,5",25,"1,5",0,0
3523701,2016,0,0,0,0,0,0
3523800,2016,0,0,0,0,0,0
3523909,2016,385,"2,4",345,"2,1",40,"0,2"
3524006,2016,86,"1,6",48,"0,9",38,"0,7"
3524105,2016,121,3,55,"1,4",66,"1,7"
3524204,2016,17,"2,6",17,"2,6",0,0
3524303,2016,172,"2,3",56,"0,8",116,"1,6"
3524402,2016,440,2,211,1,229,1
3524501,2016,191,"29,5",150,"23,2",41,"6,3"
3524600,2016,0,0,0,0,0,0
3524709,2016,80,"1,6",78,"1,5",2,0
3524808,2016,165,"3,5",112,"2,4",53,"1,1"
3524907,2016,0,0,0,0,0,0
3525003,2016,14,"0,1",0,0,14,"0,1"
3525102,2016,0,0,0,0,0,0
3525201,2016,37,"1,3",17,"0,6",20,"0,7"
3525300,2016,860,"6,1",705,5,155,"1,1"
3525409,2016,0,0,0,0,0,0
3525508,2016,24,"1,9",17,"1,4",7,"0,6"
3525607,2016,0,0,0,0,0,0
3525706,2016,61,"1,8",28,"0,8",33,1
3525805,2016,0,0,0,0,0,0
3525854,2016,0,0,0,0,0,0
3525904,2016,796,2,386,1,410,1
3526001,2016,52,"2,7",26,"1,3",26,"1,3"
3526100,2016,15,"0,8",15,"0,8",0,0
3526209,2016,9,"0,3",0,0,9,"0,3"
3526308,2016,0,0,0,0,0,0
3526407,2016,47,"1,8",32,"1,2",15,"0,6"
3526506,2016,0,0,0,0,0,0
3526605,2016,0,0,0,0,0,0
3526704,2016,130,"1,3",83,"0,9",47,"0,5"
3526803,2016,81,"1,3",54,"0,8",27,"0,4"
3526902,2016,398,"1,4",199,"0,7",199,"0,7"
3527009,2016,0,0,0,0,0,0
3527108,2016,451,"6,1",349,"4,7",102,"1,4"
3527207,2016,172,2,81,1,91,"1,1"
3527256,2016,0,0,0,0,0,0
3527306,2016,36,"0,8",29,"0,7",7,"0,2"
3527405,2016,25,"1,2",15,"0,7",10,"0,5"
3527504,2016,0,0,0,0,0,0
3527603,2016,0,0,0,0,0,0
3527702,2016,32,"5,9",15,"2,7",17,"3,1"
3527801,2016,0,0,0,0,0,0
3527900,2016,0,0,0,0,0,0
3528007,2016,31,"1,9",18,"1,1",13,"0,8"
3528106,2016,18,"2,3",15,"1,9",3,"0,4"
3528205,2016,0,0,0,0,0,0
3528304,2016,0,0,0,0,0,0
3528403,2016,0,0,0,0,0,0
3528502,2016,72,"0,8",47,"0,5",25,"0,3"
3528601,2016,0,0,0,0,0,0
3528700,2016,0,0,0,0,0,0
3528809,2016,26,"1,9",22,"1,6",4,"0,3"
3528858,2016,0,0,0,0,0,0
3528908,2016,0,0,0,0,0,0
3529005,2016,890,"3,9",709,"3,1",181,"0,8"
3529104,2016,0,0,0,0,0,0
3529203,2016,51,2,43,"1,7",8,"0,3"
3529302,2016,162,"2,1",96,"1,2",66,"0,8"
3529401,2016,445,1,302,"0,7",143,"0,3"
3529500,2016,0,0,0,0,0,0
3529609,2016,0,0,0,0,0,0
3529658,2016,0,0,0,0,0,0
3529708,2016,66,"3,1",47,"2,2",19,"0,9"
3529807,2016,0,0,0,0,0,0
3529906,2016,0,0,0,0,0,0
3530003,2016,0,0,0,0,0,0
3530102,2016,90,"3,2",90,"3,2",0,0
3530201,2016,0,0,0,0,0,0
3530300,2016,78,"1,4",29,"0,5",49,"0,9"
3530409,2016,0,0,0,0,0,0
3530508,2016,135,2,86,"1,3",49,"0,7"
3530607,2016,759,"1,8",636,"1,5",123,"0,3"
3530706,2016,333,"2,3",154,"1,1",179,"1,2"
3530805,2016,225,"2,5",123,"1,4",102,"1,1"
3530904,2016,0,0,0,0,0,0
3531001,2016,0,0,0,0,0,0
3531100,2016,44,"0,9",44,"0,9",0,0
3531209,2016,0,0,0,0,0,0
3531308,2016,109,"2,3",58,"1,2",51,"1,1"
3531407,2016,80,"3,5",30,"1,3",50,"2,2"
3531506,2016,70,"3,8",51,"2,8",19,1
3531605,2016,0,0,0,0,0,0
3531704,2016,0,0,0,0,0,0
3531803,2016,36,"0,7",29,"0,5",7,"0,1"
3531902,2016,45,"1,4",31,1,14,"0,5"
3532009,2016,20,"1,6",10,"0,8",10,"0,8"
3532058,2016,0,0,0,0,0,0
3532108,2016,0,0,0,0,0,0
3532157,2016,0,0,0,0,0,0
3532207,2016,0,0,0,0,0,0
3532306,2016,0,0,0,0,0,0
3532405,2016,24,"1,4",24,"1,4",0,0
3532504,2016,35,4,11,"1,3",24,"2,8"
3532603,2016,129,12,35,"3,2",94,"8,7"
3532702,2016,0,0,0,0,0,0
3532801,2016,0,0,0,0,0,0
3532827,2016,0,0,0,0,0,0
3532843,2016,0,0,0,0,0,0
3532868,2016,0,0,0,0,0,0
3532900,2016,12,"1,2",7,"0,7",5,"0,5"
3533007,2016,193,"9,5",19,"0,9",174,"8,6"
3533106,2016,0,0,0,0,0,0
3533205,2016,0,0,0,0,0,0
3533254,2016,0,0,0,0,0,0
3533304,2016,0,0,0,0,0,0
3533403,2016,53,1,53,1,0,0
3533502,2016,105,"2,8",35,"0,9",70,"1,8"
3533601,2016,0,0,0,0,0,0
3533700,2016,0,0,0,0,0,0
3533809,2016,0,0,0,0,0,0
3533908,2016,99,"1,9",63,"1,2",36,"0,7"
3534005,2016,0,0,0,0,0,0
3534104,2016,0,0,0,0,0,0
3534203,2016,0,0,0,0,0,0
3534302,2016,98,"2,4",59,"1,4",39,"0,9"
3534401,2016,1006,"1,5",604,"0,9",402,"0,6"
3534500,2016,0,0,0,0,0,0
3534609,2016,90,"2,9",59,"1,9",31,1
3534708,2016,185,"1,7",83,"0,8",102,"0,9"
3534757,2016,33,"3,6",28,3,5,"0,5"
3534807,2016,0,0,0,0,0,0
3534906,2016,37,"2,8",32,"2,4",5,"0,4"
3535002,2016,0,0,0,0,0,0
3535101,2016,0,0,0,0,0,0
3535200,2016,20,"2,2",9,1,11,"1,2"
3535309,2016,68,"3,2",44,"2,1",24,"1,1"
3535408,2016,36,"2,4",35,"2,3",1,"0,1"
3535507,2016,97,"2,2",78,"1,8",19,"0,4"
3535606,2016,0,0,0,0,0,0
3535705,2016,0,0,0,0,0,0
3535804,2016,30,"1,6",30,"1,6",0,0
3535903,2016,0,0,0,0,0,0
3536000,2016,32,3,26,"2,4",6,"0,6"
3536109,2016,0,0,0,0,0,0
3536208,2016,151,8,151,8,0,0
3536257,2016,0,0,0,0,0,0
3536307,2016,35,"2,5",23,"1,7",12,"0,9"
3536406,2016,0,0,0,0,0,0
3536505,2016,85,"0,9",85,"0,9",0,0
3536570,2016,0,0,0,0,0,0
3536604,2016,24,"2,8",9,"1,1",15,"1,8"
3536703,2016,72,"1,6",52,"1,2",20,"0,5"
3536802,2016,0,0,0,0,0,0
3536901,2016,0,0,0,0,0,0
3537008,2016,75,"4,7",55,"3,4",20,"1,2"
3537107,2016,98,"2,2",98,"2,2",0,0
3537156,2016,0,0,0,0,0,0
3537206,2016,0,0,0,0,0,0
3537305,2016,220,"3,7",150,"2,5",70,"1,2"
3537404,2016,92,"3,6",62,"2,5",30,"1,2"
3537503,2016,0,0,0,0,0,0
3537602,2016,0,0,0,0,0,0
3537701,2016,0,0,0,0,0,0
3537800,2016,525,"9,9",406,"7,7",119,"2,2"
3537909,2016,35,"1,3",27,1,8,"0,3"
3538006,2016,201,"1,3",127,"0,8",74,"0,5"
3538105,2016,0,0,0,0,0,0
3538204,2016,0,0,0,0,0,0
3538303,2016,0,0,0,0,0,0
3538501,2016,0,0,0,0,0,0
3538600,2016,37,"1,4",29,"1,1",8,"0,3"
3538709,2016,704,"1,9",315,"0,8",389,1
3538808,2016,77,"2,7",58,2,19,"0,7"
3538907,2016,299,"12,9",289,"12,5",10,"0,4"
3539004,2016,41,"3,8",9,"0,8",32,3
3539103,2016,0,0,0,0,0,0
3539202,2016,0,0,0,0,0,0
3539301,2016,94,"1,3",57,"0,8",37,"0,5"
3539400,2016,28,"2,2",25,2,3,"0,2"
3539509,2016,50,"1,3",32,"0,9",18,"0,5"
3539608,2016,0,0,0,0,0,0
3539707,2016,0,0,0,0,0,0
3539806,2016,35,"0,3",35,"0,3",0,0
3539905,2016,0,0,0,0,0,0
3540002,2016,42,2,36,"1,7",6,"0,3"
3540101,2016,0,0,0,0,0,0
3540200,2016,45,1,29,"0,6",16,"0,3"
3540259,2016,0,0,0,0,0,0
3540309,2016,0,0,0,0,0,0
3540408,2016,18,"4,4",8,2,10,"2,5"
3540507,2016,0,0,0,0,0,0
3540606,2016,51,1,39,"0,8",12,"0,2"
3540705,2016,61,"1,1",33,"0,6",28,"0,5"
3540754,2016,0,0,0,0,0,0
3540804,2016,31,"1,9",28,"1,7",3,"0,2"
3540853,2016,0,0,0,0,0,0
3540903,2016,0,0,0,0,0,0
3541000,2016,192,"0,6",179,"0,6",13,0
3541059,2016,0,0,0,0,0,0
3541109,2016,0,0,0,0,0,0
3541208,2016,51,"3,7",40,"2,9",11,"0,8"
3541307,2016,78,"1,9",68,"1,6",10,"0,2"
3541406,2016,1138,"5,3",760,"3,5",378,"1,7"
3541505,2016,99,"2,6",57,"1,5",42,"1,1"
3541604,2016,58,"1,5",58,"1,5",0,0
3541653,2016,0,0,0,0,0,0
3541703,2016,0,0,0,0,0,0
3541802,2016,0,0,0,0,0,0
3541901,2016,20,"1,6",20,"1,6",0,0
3542008,2016,0,0,0,0,0,0
3542107,2016,0,0,0,0,0,0
3542206,2016,98,"3,4",70,"2,4",28,1
3542305,2016,0,0,0,0,0,0
3542404,2016,24,"1,3",17,"0,9",7,"0,4"
3542503,2016,0,0,0,0,0,0
3542602,2016,115,"2,1",63,"1,2",52,1
3542701,2016,0,0,0,0,0,0
3542800,2016,0,0,0,0,0,0
3542909,2016,17,"1,3",11,"0,9",6,"0,5"
3543006,2016,36,2,35,2,1,"0,1"
3543105,2016,0,0,0,0,0,0
3543204,2016,0,0,0,0,0,0
3543238,2016,0,0,0,0,0,0
3543253,2016,0,0,0,0,0,0
3543303,2016,164,"1,4",50,"0,4",114,1
3543402,2016,2160,"3,3",1405,"2,1",755,"1,2"
3543501,2016,0,0,0,0,0,0
3543600,2016,0,0,0,0,0,0
3543709,2016,0,0,0,0,0,0
3543808,2016,23,"2,3",20,2,3,"0,3"
3543907,2016,477,"2,4",267,"1,4",210,"1,1"
3544004,2016,47,"1,4",28,"0,9",19,"0,6"
3544103,2016,0,0,0,0,0,0
3544202,2016,36,"3,2",7,"0,6",29,"2,6"
3544251,2016,57,3,57,3,0,0
3544301,2016,14,"1,4",14,"1,4",0,0
3544400,2016,0,0,0,0,0,0
3544509,2016,0,0,0,0,0,0
3544608,2016,0,0,0,0,0,0
3544707,2016,0,0,0,0,0,0
3544806,2016,0,0,0,0,0,0
3544905,2016,29,"2,6",19,"1,7",10,"0,9"
3545001,2016,19,"1,2",17,1,2,"0,1"
3545100,2016,0,0,0,0,0,0
3545159,2016,0,0,0,0,0,0
3545209,2016,125,"1,1",72,"0,6",53,"0,5"
3545308,2016,921,"21,6",723,"16,9",198,"4,6"
3545407,2016,34,"3,8",22,"2,5",12,"1,3"
3545506,2016,0,0,0,0,0,0
3545605,2016,24,"1,6",7,"0,5",17,"1,2"
3545704,2016,0,0,0,0,0,0
3545803,2016,146,"0,8",73,"0,4",73,"0,4"
3546009,2016,0,0,0,0,0,0
3546108,2016,0,0,0,0,0,0
3546207,2016,0,0,0,0,0,0
3546256,2016,0,0,0,0,0,0
3546306,2016,46,"1,4",25,"0,8",21,"0,7"
3546405,2016,100,"2,2",65,"1,4",35,"0,8"
3546504,2016,0,0,0,0,0,0
3546603,2016,68,"2,3",33,"1,1",35,"1,2"
3546702,2016,0,0,0,0,0,0
3546801,2016,101,"1,9",82,"1,5",19,"0,4"
3546900,2016,0,0,0,0,0,0
3547007,2016,6,1,6,1,0,0
3547106,2016,0,0,0,0,0,0
3547205,2016,0,0,0,0,0,0
3547304,2016,35,"0,3",35,"0,3",0,0
3547403,2016,0,0,0,0,0,0
3547502,2016,299,"11,3",276,"10,4",23,"0,9"
3547601,2016,30,"1,2",18,"0,7",12,"0,5"
3547650,2016,0,0,0,0,0,0
3547700,2016,56,"2,8",37,"1,8",19,"0,9"
3547809,2016,1335,"1,9",684,1,651,"0,9"
3547908,2016,12,"1,8",12,"1,8",0,0
3548005,2016,0,0,0,0,0,0
3548054,2016,0,0,0,0,0,0
3548104,2016,0,0,0,0,0,0
3548203,2016,0,0,0,0,0,0
3548302,2016,0,0,0,0,0,0
3548401,2016,0,0,0,0,0,0
3548500,2016,1644,"3,9",814,"1,9",830,2
3548609,2016,40,"3,8",26,"2,5",14,"1,3"
3548708,2016,1543,"1,9",560,"0,7",983,"1,2"
3548807,2016,426,"2,8",184,"1,2",242,"1,6"
3548906,2016,417,"1,8",198,"0,8",219,"0,9"
3549003,2016,0,0,0,0,0,0
3549102,2016,199,"2,3",94,"1,1",105,"1,2"
3549201,2016,0,0,0,0,0,0
3549250,2016,0,0,0,0,0,0
3549300,2016,0,0,0,0,0,0
3549409,2016,115,"2,4",68,"1,4",47,1
3549508,2016,0,0,0,0,0,0
3549607,2016,0,0,0,0,0,0
3549706,2016,136,"2,6",81,"1,5",55,1
3549805,2016,1820,"4,2",916,"2,1",904,"2,1"
3549904,2016,1502,"2,2",736,"1,1",766,"1,1"
3549953,2016,0,0,0,0,0,0
3550001,2016,26,"2,5",11,1,15,"1,4"
3550100,2016,43,"1,1",36,"0,9",7,"0,2"
3550209,2016,42,"1,3",42,"1,3",0,0
3550308,2016,28766,"2,5",15147,"1,3",13619,"1,2"
3550407,2016,62,"1,9",37,"1,1",25,"0,8"
3550506,2016,0,0,0,0,0,0
3550605,2016,89,"1,1",41,"0,5",48,"0,6"
3550704,2016,101,"1,2",93,"1,1",8,"0,1"
3550803,2016,30,"2,5",26,"2,2",4,"0,3"
3550902,2016,50,"3,4",38,"2,6",12,"0,8"
3551009,2016,283,"0,8",166,"0,5",117,"0,3"
3551108,2016,0,0,0,0,0,0
3551207,2016,0,0,0,0,0,0
3551306,2016,0,0,0,0,0,0
3551405,2016,0,0,0,0,0,0
3551504,2016,58,"1,4",43,1,15,"0,4"
3551603,2016,49,"1,8",33,"1,2",16,"0,6"
3551702,2016,157,"1,3",64,"0,5",93,"0,8"
3551801,2016,0,0,0,0,0,0
3551900,2016,0,0,0,0,0,0
3552007,2016,3,"0,5",3,"0,5",0,0
3552106,2016,62,"1,6",54,"1,4",8,"0,2"
3552205,2016,1572,"2,5",1021,"1,6",551,"0,9"
3552304,2016,20,"2,6",20,"2,6",0,0
3552403,2016,181,"0,7",172,"0,6",9,0
3552502,2016,184,"0,7",84,"0,3",100,"0,4"
3552551,2016,0,0,0,0,0,0
3552601,2016,30,"2,6",9,"0,8",21,"1,8"
3552700,2016,35,"2,3",22,"1,4",13,"0,8"
3552809,2016,387,"1,4",334,"1,2",53,"0,2"
3552908,2016,0,0,0,0,0,0
3553005,2016,29,"2,3",24,"1,9",5,"0,4"
3553104,2016,0,0,0,0,0,0
3553203,2016,4,"0,6",4,"0,6",0,0
3553302,2016,36,"1,6",25,"1,1",11,"0,5"
3553401,2016,72,"2,9",30,"1,2",42,"1,7"
3553500,2016,0,0,0,0,0,0
3553609,2016,24,"1,9",19,"1,5",5,"0,4"
3553658,2016,0,0,0,0,0,0
3553708,2016,124,"2,3",73,"1,3",51,"0,9"
3553807,2016,53,"2,3",32,"1,4",21,"0,9"
3553856,2016,0,0,0,0,0,0
3553906,2016,0,0,0,0,0,0
3553955,2016,0,0,0,0,0,0
3554003,2016,179,"1,6",91,"0,8",88,"0,8"
3554102,2016,479,"1,6",325,"1,1",154,"0,5"
3554201,2016,0,0,0,0,0,0
3554300,2016,58,"2,6",52,"2,4",6,"0,3"
3554409,2016,34,"3,8",30,"3,4",4,"0,5"
3554508,2016,69,"1,7",42,"1,1",27,"0,7"
3554607,2016,0,0,0,0,0,0
3554656,2016,0,0,0,0,0,0
3554706,2016,20,"2,1",13,"1,4",7,"0,7"
3554755,2016,0,0,0,0,0,0
3554805,2016,0,0,0,0,0,0
3554904,2016,0,0,0,0,0,0
3554953,2016,0,0,0,0,0,0
3555000,2016,640,"10,1",571,"9,1",69,"1,1"
3555109,2016,48,"3,2",30,2,18,"1,2"
3555208,2016,0,0,0,0,0,0
3555307,2016,0,0,0,0,0,0
3555356,2016,0,0,0,0,0,0
3555406,2016,80,"0,9",74,"0,9",6,"0,1"
3555505,2016,0,0,0,0,0,0
3555604,2016,0,0,0,0,0,0
3555703,2016,0,0,0,0,0,0
3555802,2016,26,3,24,"2,8",2,"0,2"
3555901,2016,0,0,0,0,0,0
3556008,2016,34,"2,6",13,1,21,"1,6"
3556107,2016,0,0,0,0,0,0
3556206,2016,169,"1,4",63,"0,5",106,"0,9"
3556305,2016,55,"2,3",31,"1,3",24,1
3556354,2016,0,0,0,0,0,0
3556404,2016,77,"1,9",47,"1,2",30,"0,7"
3556453,2016,0,0,0,0,0,0
3556503,2016,35,"0,3",33,"0,3",2,0
3556602,2016,36,"3,4",0,0,36,"3,4"
3556701,2016,67,"0,9",48,"0,7",19,"0,3"
3556800,2016,48,"2,7",30,"1,7",18,1
3556909,2016,0,0,0,0,0,0
3556958,2016,0,0,0,0,0,0
3557006,2016,172,"1,5",88,"0,8",84,"0,7"
3557105,2016,204,"2,3",115,"1,3",89,1
3557154,2016,0,0,0,0,0,0
3557204,2016,50,"4,1",30,"2,5",20,"1,6"
3557303,2016,0,0,0,0,0,0
3500105,2017,258,"7,6",219,"6,5",39,"1,2"
3500204,2017,0,0,0,0,0,0
3500303,2017,10,"0,3",0,0,10,"0,3"
3500402,2017,0,0,0,0,0,0
3500501,2017,42,"2,3",30,"1,7",12,"0,7"
3500550,2017,0,0,0,0,0,0
3500600,2017,0,0,0,0,0,0
3500709,2017,60,"1,7",38,"1,1",22,"0,6"
3500758,2017,0,0,0,0,0,0
3500808,2017,0,0,0,0,0,0
3500907,2017,0,0,0,0,0,0
3501004,2017,31,2,25,"1,6",6,"0,4"
3501103,2017,22,"5,4",19,"4,7",3,"0,7"
3501152,2017,0,0,0,0,0,0
3501202,2017,0,0,0,0,0,0
3501301,2017,20,"0,8",18,"0,8",2,"0,1"
3501400,2017,0,0,0,0,0,0
3501509,2017,0,0,0,0,0,0
3501608,2017,571,"2,5",205,"0,9",366,"1,6"
3501707,2017,220,"5,7",220,"5,7",0,0
3501806,2017,0,0,0,0,0,0
3501905,2017,377,"5,5",224,"3,3",153,"2,2"
3502002,2017,0,0,0,0,0,0
3502101,2017,136,"2,4",110,2,26,"0,5"
3502200,2017,57,"2,4",54,"2,3",3,"0,1"
3502309,2017,0,0,0,0,0,0
3502408,2017,0,0,0,0,0,0
3502507,2017,104,"2,9",70,2,34,1
3502606,2017,22,"5,2",20,"4,7",2,"0,5"
3502705,2017,51,"2,1",45,"1,8",6,"0,2"
3502754,2017,0,0,0,0,0,0
3502804,2017,479,"2,5",333,"1,8",146,"0,8"
3502903,2017,411,"13,3",0,0,411,"13,3"
3503000,2017,0,0,0,0,0,0
3503109,2017,16,"2,6",16,"2,6",0,0
3503158,2017,0,0,0,0,0,0
3503208,2017,443,2,216,1,227,1
3503307,2017,557,"4,4",300,"2,4",257,2
3503356,2017,0,0,0,0,0,0
3503406,2017,28,"3,5",17,"2,1",11,"1,4"
3503505,2017,0,0,0,0,0,0
3503604,2017,0,0,0,0,0,0
3503703,2017,25,"2,7",4,"0,4",21,"2,3"
3503802,2017,24,"0,5",0,0,24,"0,5"
3503901,2017,92,"1,1",24,"0,3",68,"0,8"
3503950,2017,0,0,0,0,0,0
3504008,2017,280,"2,8",159,"1,6",121,"1,2"
3504107,2017,192,"1,4",55,"0,4",137,1
3504206,2017,44,"3,1",35,"2,4",9,"0,6"
3504305,2017,0,0,0,0,0,0
3504404,2017,0,0,0,0,0,0
3504503,2017,159,"1,8",95,"1,1",64,"0,7"
3504602,2017,0,0,0,0,0,0
3504701,2017,0,0,0,0,0,0
3504800,2017,0,0,0,0,0,0
3504909,2017,15,"1,4",15,"1,4",0,0
3505005,2017,0,0,0,0,0,0
3505104,2017,0,0,0,0,0,0
3505203,2017,51,"1,5",34,1,17,"0,5"
3505302,2017,101,"2,9",68,"1,9",33,"0,9"
3505351,2017,0,0,0,0,0,0
3505401,2017,0,0,0,0,0,0
3505500,2017,513,"4,4",425,"3,6",88,"0,8"
3505609,2017,0,0,0,0,0,0
3505708,2017,499,"1,9",351,"1,4",148,"0,6"
3505807,2017,35,"1,7",28,"1,4",7,"0,3"
3505906,2017,133,"2,2",101,"1,7",32,"0,5"
3506003,2017,1161,"3,2",612,"1,7",549,"1,5"
3506102,2017,124,"1,7",75,1,49,"0,7"
3506201,2017,0,0,0,0,0,0
3506300,2017,23,"2,1",20,"1,9",3,"0,3"
3506359,2017,49,"0,8",49,"0,8",0,0
3506409,2017,36,"4,7",36,"4,7",0,0
3506508,2017,168,"1,4",88,"0,7",80,"0,7"
3506607,2017,0,0,0,0,0,0
3506706,2017,15,1,13,"0,9",2,"0,1"
3506805,2017,35,3,29,"2,5",6,"0,5"
3506904,2017,0,0,0,0,0,0
3507001,2017,53,1,36,"0,7",17,"0,3"
3507100,2017,11,"0,5",11,"0,5",0,0
3507159,2017,0,0,0,0,0,0
3507209,2017,0,0,0,0,0,0
3507308,2017,0,0,0,0,0,0
3507407,2017,26,"1,7",16,"1,1",10,"0,7"
3507456,2017,0,0,0,0,0,0
3507506,2017,741,"5,4",541,"3,9",200,"1,5"
3507605,2017,454,"2,9",210,"1,3",244,"1,5"
3507704,2017,0,0,0,0,0,0
3507753,2017,0,0,0,0,0,0
3507803,2017,0,0,0,0,0,0
3507902,2017,41,"1,8",35,"1,5",6,"0,3"
3508009,2017,0,0,0,0,0,0
3508108,2017,42,"2,6",22,"1,4",20,"1,2"
3508207,2017,0,0,0,0,0,0
3508306,2017,0,0,0,0,0,0
3508405,2017,16,"0,3",11,"0,2",5,"0,1"
3508504,2017,139,"1,6",63,"0,7",76,"0,8"
3508603,2017,47,"1,5",40,"1,3",7,"0,2"
3508702,2017,62,"3,3",62,"3,3",0,0
3508801,2017,58,"3,4",47,"2,8",11,"0,6"
3508900,2017,0,0,0,0,0,0
3509007,2017,130,"1,3",61,"0,6",69,"0,7"
3509106,2017,0,0,0,0,0,0
3509205,2017,155,"2,1",55,"0,7",100,"1,4"
3509254,2017,0,0,0,0,0,0
3509304,2017,32,"3,2",26,"2,6",6,"0,6"
3509403,2017,140,"5,6",55,"2,2",85,"3,4"
3509452,2017,0,0,0,0,0,0
3509502,2017,2749,"2,4",1311,"1,1",1438,"1,2"
3509601,2017,68,"0,8",68,"0,8",0,0
3509700,2017,201,"4,1",191,"3,9",10,"0,2"
3509809,2017,0,0,0,0,0,0
3509908,2017,0,0,0,0,0,0
3509957,2017,0,0,0,0,0,0
3510005,2017,30,1,25,"0,8",5,"0,2"
3510104,2017,0,0,0,0,0,0
3510153,2017,0,0,0,0,0,0
3510203,2017,67,"1,4",49,"1,1",18,"0,4"
3510302,2017,14,"0,7",14,"0,7",0,0
3510401,2017,96,"1,8",46,"0,9",50,1
3510500,2017,165,"1,5",107,1,58,"0,5"
3510609,2017,270,"0,7",220,"0,6",50,"0,1"
3510708,2017,31,"2,6",13,"1,1",18,"1,5"
3510807,2017,372,"12,8",356,"12,2",16,"0,5"
3510906,2017,0,0,0,0,0,0
3511003,2017,31,"1,6",30,"1,5",1,"0,1"
3511102,2017,533,"4,6",374,"3,2",159,"1,4"
3511201,2017,0,0,0,0,0,0
3511300,2017,50,"5,8",0,0,50,"5,8"
3511409,2017,52,"2,8",34,"1,8",18,1
3511508,2017,37,"0,8",29,"0,7",8,"0,2"
3511607,2017,30,"1,8",17,1,13,"0,8"
3511706,2017,33,2,26,"1,6",7,"0,4"
3511904,2017,30,"3,8",20,"2,5",10,"1,3"
3512001,2017,47,"2,7",35,2,12,"0,7"
3512100,2017,20,"3,3",20,"3,3",0,0
3512209,2017,55,"2,1",50,"1,9",5,"0,2"
3512308,2017,32,"1,9",32,"1,9",0,0
3512407,2017,0,0,0,0,0,0
3512506,2017,0,0,0,0,0,0
3512605,2017,6,"1,2",6,"1,2",0,0
3512704,2017,0,0,0,0,0,0
3512803,2017,90,"1,3",0,0,90,"1,3"
3512902,2017,0,0,0,0,0,0
3513009,2017,503,"2,2",111,"0,5",392,"1,7"
3513108,2017,15,"0,4",13,"0,4",2,"0,1"
3513207,2017,0,0,0,0,0,0
3513306,2017,0,0,0,0,0,0
3513405,2017,122,"1,5",77,1,45,"0,6"
3513504,2017,118,"0,9",66,"0,5",52,"0,4"
3513603,2017,40,"1,8",25,"1,2",15,"0,7"
3513702,2017,40,"1,2",25,"0,8",15,"0,5"
3513801,2017,624,"1,6",545,"1,4",79,"0,2"
3513850,2017,0,0,0,0,0,0
3513900,2017,186,17,186,17,0,0
3514007,2017,0,0,0,0,0,0
3514106,2017,67,"2,5",47,"1,8",20,"0,8"
3514205,2017,0,0,0,0,0,0
3514304,2017,18,"2,1",18,"2,1",0,0
3514403,2017,143,"3,2",108,"2,4",35,"0,8"
3514502,2017,87,"7,2",77,"6,4",10,"0,8"
3514601,2017,0,0,0,0,0,0
3514700,2017,0,0,0,0,0,0
3514809,2017,2,"0,1",2,"0,1",0,0
3514908,2017,6,"0,4",6,"0,4",0,0
3514924,2017,0,0,0,0,0,0
3514957,2017,0,0,0,0,0,0
3515004,2017,94,"0,4",89,"0,3",5,0
3515103,2017,16,"0,2",16,"0,2",0,0
3515129,2017,0,0,0,0,0,0
3515152,2017,0,0,0,0,0,0
3515186,2017,453,"10,7",365,"8,6",88,"2,1"
3515194,2017,0,0,0,0,0,0
3515202,2017,50,"6,1",45,"5,5",5,"0,6"
3515301,2017,0,0,0,0,0,0
3515350,2017,0,0,0,0,0,0
3515400,2017,20,"1,3",12,"0,8",8,"0,5"
3515509,2017,135,"2,1",84,"1,3",51,"0,8"
3515608,2017,0,0,0,0,0,0
3515657,2017,0,0,0,0,0,0
3515707,2017,189,1,189,1,0,0
3515806,2017,0,0,0,0,0,0
3515905,2017,0,0,0,0,0,0
3516002,2017,47,"3,8",30,"2,4",17,"1,4"
3516101,2017,0,0,0,0,0,0
3516200,2017,738,"2,2",486,"1,4",252,"0,8"
3516309,2017,147,"0,9",98,"0,6",49,"0,3"
3516408,2017,672,"4,6",590,4,82,"0,6"
3516507,2017,0,0,0,0,0,0
3516606,2017,45,"6,8",27,"4,1",18,"2,7"
3516705,2017,365,"8,6",332,"7,8",33,"0,8"
3516804,2017,0,0,0,0,0,0
3516853,2017,0,0,0,0,0,0
3516903,2017,32,3,20,"1,9",12,"1,1"
3517000,2017,48,"4,4",36,"3,3",12,"1,1"
3517109,2017,0,0,0,0,0,0
3517208,2017,0,0,0,0,0,0
3517307,2017,0,0,0,0,0,0
3517406,2017,60,"1,6",42,"1,1",18,"0,5"
3517505,2017,0,0,0,0,0,0
3517604,2017,19,"1,1",19,"1,1",0,0
3517703,2017,30,"1,5",22,"1,1",8,"0,4"
3517802,2017,23,"2,7",15,"1,8",8,"0,9"
3517901,2017,0,0,0,0,0,0
3518008,2017,0,0,0,0,0,0
3518107,2017,0,0,0,0,0,0
3518206,2017,74,"2,3",48,"1,5",26,"0,8"
3518305,2017,35,"1,2",29,1,6,"0,2"
3518404,2017,244,"2,1",156,"1,3",88,"0,8"
3518503,2017,0,0,0,0,0,0
3518602,2017,72,"1,9",65,"1,7",7,"0,2"
3518701,2017,391,"1,3",219,"0,7",172,"0,6"
3518800,2017,1991,"1,5",1456,"1,1",535,"0,4"
3518859,2017,0,0,0,0,0,0
3518909,2017,0,0,0,0,0,0
3519006,2017,58,"6,4",58,"6,4",0,0
3519055,2017,0,0,0,0,0,0
3519071,2017,91,"0,4",62,"0,3",29,"0,1"
3519105,2017,30,"2,7",28,"2,6",2,"0,2"
3519204,2017,0,0,0,0,0,0
3519253,2017,0,0,0,0,0,0
3519303,2017,32,1,32,1,0,0
3519402,2017,27,"2,3",10,"0,9",17,"1,4"
3519501,2017,0,0,0,0,0,0
3519600,2017,99,"1,7",52,"0,9",47,"0,8"
3519709,2017,67,"0,9",63,"0,8",4,"0,1"
3519808,2017,0,0,0,0,0,0
3519907,2017,20,"2,6",20,"2,6",0,0
3520004,2017,63,"2,6",0,0,63,"2,6"
3520103,2017,60,"2,1",32,"1,1",28,1
3520202,2017,15,"1,6",15,"1,6",0,0
3520301,2017,9,"0,3",9,"0,3",0,0
3520400,2017,49,"1,5",46,"1,4",3,"0,1"
3520426,2017,0,0,0,0,0,0
3520442,2017,116,"4,5",74,"2,9",42,"1,6"
3520509,2017,362,"1,6",232,1,130,"0,6"
3520608,2017,0,0,0,0,0,0
3520707,2017,36,"9,3",4,1,32,"8,3"
3520806,2017,0,0,0,0,0,0
3520905,2017,49,"3,4",29,2,20,"1,4"
3521002,2017,15,"0,5",15,"0,5",0,0
3521101,2017,0,0,0,0,0,0
3521150,2017,0,0,0,0,0,0
3521200,2017,0,0,0,0,0,0
3521309,2017,49,"3,2",39,"2,5",10,"0,7"
3521408,2017,0,0,0,0,0,0
3521507,2017,0,0,0,0,0,0
3521606,2017,0,0,0,0,0,0
3521705,2017,35,2,35,2,0,0
3521804,2017,35,"1,4",35,"1,4",0,0
3521903,2017,30,"2,1",20,"1,4",10,"0,7"
3522000,2017,0,0,0,0,0,0
3522109,2017,77,"0,8",77,"0,8",0,0
3522158,2017,0,0,0,0,0,0
3522208,2017,501,3,176,"1,1",325,2
3522307,2017,122,"0,8",100,"0,6",22,"0,1"
3522406,2017,145,"1,6",103,"1,1",42,"0,5"
3522505,2017,306,"1,4",217,1,89,"0,4"
3522604,2017,1041,"14,7",578,"8,2",463,"6,5"
3522653,2017,0,0,0,0,0,0
3522703,2017,76,"1,8",46,"1,1",30,"0,7"
3522802,2017,46,"3,1",27,"1,8",19,"1,3"
3522901,2017,30,"2,3",25,"1,9",5,"0,4"
3523008,2017,0,0,0,0,0,0
3523107,2017,224,"0,6",224,"0,6",0,0
3523206,2017,96,2,78,"1,6",18,"0,4"
3523305,2017,0,0,0,0,0,0
3523404,2017,119,"1,1",60,"0,5",59,"0,5"
3523503,2017,14,"0,7",7,"0,4",7,"0,4"
3523602,2017,25,"1,5",25,"1,5",0,0
3523701,2017,0,0,0,0,0,0
3523800,2017,0,0,0,0,0,0
3523909,2017,463,"2,8",423,"2,6",40,"0,2"
3524006,2017,86,"1,6",48,"0,9",38,"0,7"
3524105,2017,121,3,55,"1,4",66,"1,7"
3524204,2017,17,"2,6",17,"2,6",0,0
3524303,2017,212,"2,9",56,"0,8",156,"2,1"
3524402,2017,389,"1,7",161,"0,7",228,1
3524501,2017,216,"32,8",150,"22,8",66,10
3524600,2017,0,0,0,0,0,0
3524709,2017,80,"1,5",78,"1,5",2,0
3524808,2017,163,"3,5",112,"2,4",51,"1,1"
3524907,2017,0,0,0,0,0,0
3525003,2017,14,"0,1",0,0,14,"0,1"
3525102,2017,0,0,0,0,0,0
3525201,2017,37,"1,3",17,"0,6",20,"0,7"
3525300,2017,905,"6,3",715,5,190,"1,3"
3525409,2017,0,0,0,0,0,0
3525508,2017,11,"0,9",11,"0,9",0,0
3525607,2017,0,0,0,0,0,0
3525706,2017,61,"1,7",28,"0,8",33,"0,9"
3525805,2017,0,0,0,0,0,0
3525854,2017,0,0,0,0,0,0
3525904,2017,812,2,440,"1,1",372,"0,9"
3526001,2017,51,"2,6",25,"1,3",26,"1,3"
3526100,2017,15,"0,8",15,"0,8",0,0
3526209,2017,9,"0,3",0,0,9,"0,3"
3526308,2017,0,0,0,0,0,0
3526407,2017,46,"1,7",28,1,18,"0,7"
3526506,2017,0,0,0,0,0,0
3526605,2017,0,0,0,0,0,0
3526704,2017,144,"1,5",105,"1,1",39,"0,4"
3526803,2017,87,"1,3",60,"0,9",27,"0,4"
3526902,2017,405,"1,4",200,"0,7",205,"0,7"
3527009,2017,0,0,0,0,0,0
3527108,2017,453,"6,1",349,"4,7",104,"1,4"
3527207,2017,164,"1,9",85,1,79,"0,9"
3527256,2017,0,0,0,0,0,0
3527306,2017,34,"0,8",27,"0,6",7,"0,2"
3527405,2017,15,"0,7",10,"0,5",5,"0,2"
3527504,2017,0,0,0,0,0,0
3527603,2017,0,0,0,0,0,0
3527702,2017,0,0,0,0,0,0
3527801,2017,0,0,0,0,0,0
3527900,2017,0,0,0,0,0,0
3528007,2017,31,"1,9",18,"1,1",13,"0,8"
3528106,2017,18,"2,3",15,"1,9",3,"0,4"
3528205,2017,0,0,0,0,0,0
3528304,2017,0,0,0,0,0,0
3528403,2017,0,0,0,0,0,0
3528502,2017,72,"0,8",41,"0,4",31,"0,3"
3528601,2017,0,0,0,0,0,0
3528700,2017,0,0,0,0,0,0
3528809,2017,26,"1,9",22,"1,6",4,"0,3"
3528858,2017,0,0,0,0,0,0
3528908,2017,0,0,0,0,0,0
3529005,2017,742,"3,3",564,"2,5",178,"0,8"
3529104,2017,0,0,0,0,0,0
3529203,2017,36,"1,4",27,"1,1",9,"0,4"
3529302,2017,162,2,96,"1,2",66,"0,8"
3529401,2017,401,"0,9",246,"0,5",155,"0,3"
3529500,2017,0,0,0,0,0,0
3529609,2017,0,0,0,0,0,0
3529658,2017,0,0,0,0,0,0
3529708,2017,66,"3,1",47,"2,2",19,"0,9"
3529807,2017,0,0,0,0,0,0
3529906,2017,0,0,0,0,0,0
3530003,2017,0,0,0,0,0,0
3530102,2017,67,"2,4",61,"2,2",6,"0,2"
3530201,2017,0,0,0,0,0,0
3530300,2017,78,"1,4",29,"0,5",49,"0,9"
3530409,2017,0,0,0,0,0,0
3530508,2017,135,2,86,"1,3",49,"0,7"
3530607,2017,763,"1,8",601,"1,4",162,"0,4"
3530706,2017,333,"2,3",154,"1,1",179,"1,2"
3530805,2017,213,"2,4",114,"1,3",99,"1,1"
3530904,2017,0,0,0,0,0,0
3531001,2017,0,0,0,0,0,0
3531100,2017,48,"0,9",48,"0,9",0,0
3531209,2017,0,0,0,0,0,0
3531308,2017,109,"2,3",58,"1,2",51,"1,1"
3531407,2017,80,"3,5",30,"1,3",50,"2,2"
3531506,2017,70,"3,8",51,"2,8",19,1
3531605,2017,0,0,0,0,0,0
3531704,2017,0,0,0,0,0,0
3531803,2017,35,"0,6",26,"0,5",9,"0,2"
3531902,2017,45,"1,4",31,1,14,"0,4"
3532009,2017,20,"1,6",10,"0,8",10,"0,8"
3532058,2017,0,0,0,0,0,0
3532108,2017,0,0,0,0,0,0
3532157,2017,0,0,0,0,0,0
3532207,2017,0,0,0,0,0,0
3532306,2017,0,0,0,0,0,0
3532405,2017,20,"1,1",20,"1,1",0,0
3532504,2017,21,"2,4",10,"1,2",11,"1,3"
3532603,2017,129,12,35,"3,2",94,"8,7"
3532702,2017,0,0,0,0,0,0
3532801,2017,0,0,0,0,0,0
3532827,2017,0,0,0,0,0,0
3532843,2017,0,0,0,0,0,0
3532868,2017,0,0,0,0,0,0
3532900,2017,12,"1,2",7,"0,7",5,"0,5"
3533007,2017,62,3,19,"0,9",43,"2,1"
3533106,2017,0,0,0,0,0,0
3533205,2017,0,0,0,0,0,0
3533254,2017,0,0,0,0,0,0
3533304,2017,0,0,0,0,0,0
3533403,2017,53,"0,9",53,"0,9",0,0
3533502,2017,105,"2,7",35,"0,9",70,"1,8"
3533601,2017,0,0,0,0,0,0
3533700,2017,0,0,0,0,0,0
3533809,2017,0,0,0,0,0,0
3533908,2017,99,"1,9",60,"1,2",39,"0,8"
3534005,2017,0,0,0,0,0,0
3534104,2017,0,0,0,0,0,0
3534203,2017,0,0,0,0,0,0
3534302,2017,98,"2,4",59,"1,4",39,"0,9"
3534401,2017,1000,"1,5",591,"0,9",409,"0,6"
3534500,2017,0,0,0,0,0,0
3534609,2017,73,"2,3",59,"1,9",14,"0,4"
3534708,2017,169,"1,6",83,"0,8",86,"0,8"
3534757,2017,33,"3,5",28,3,5,"0,5"
3534807,2017,0,0,0,0,0,0
3534906,2017,37,"2,8",32,"2,4",5,"0,4"
3535002,2017,0,0,0,0,0,0
3535101,2017,0,0,0,0,0,0
3535200,2017,20,"2,2",10,"1,1",10,"1,1"
3535309,2017,54,"2,5",36,"1,7",18,"0,8"
3535408,2017,36,"2,4",35,"2,3",1,"0,1"
3535507,2017,97,"2,2",78,"1,8",19,"0,4"
3535606,2017,0,0,0,0,0,0
3535705,2017,0,0,0,0,0,0
3535804,2017,30,"1,6",30,"1,6",0,0
3535903,2017,0,0,0,0,0,0
3536000,2017,32,3,26,"2,5",6,"0,6"
3536109,2017,0,0,0,0,0,0
3536208,2017,149,"7,8",149,"7,8",0,0
3536257,2017,0,0,0,0,0,0
3536307,2017,35,"2,5",23,"1,6",12,"0,9"
3536406,2017,0,0,0,0,0,0
3536505,2017,85,"0,9",85,"0,9",0,0
3536570,2017,0,0,0,0,0,0
3536604,2017,24,"2,8",9,"1,1",15,"1,8"
3536703,2017,72,"1,6",52,"1,2",20,"0,5"
3536802,2017,0,0,0,0,0,0
3536901,2017,0,0,0,0,0,0
3537008,2017,75,"4,7",55,"3,4",20,"1,2"
3537107,2017,98,"2,2",98,"2,2",0,0
3537156,2017,0,0,0,0,0,0
3537206,2017,0,0,0,0,0,0
3537305,2017,254,"4,2",175,"2,9",79,"1,3"
3537404,2017,52,"2,1",47,"1,9",5,"0,2"
3537503,2017,0,0,0,0,0,0
3537602,2017,14,"0,2",14,"0,2",0,0
3537701,2017,0,0,0,0,0,0
3537800,2017,290,"5,5",258,"4,9",32,"0,6"
3537909,2017,35,"1,3",27,1,8,"0,3"
3538006,2017,201,"1,3",127,"0,8",74,"0,5"
3538105,2017,0,0,0,0,0,0
3538204,2017,0,0,0,0,0,0
3538303,2017,0,0,0,0,0,0
3538501,2017,0,0,0,0,0,0
3538600,2017,37,"1,4",29,"1,1",8,"0,3"
3538709,2017,715,"1,9",282,"0,7",433,"1,1"
3538808,2017,77,"2,7",58,2,19,"0,7"
3538907,2017,285,"12,3",78,"3,4",207,"8,9"
3539004,2017,41,"3,8",9,"0,8",32,3
3539103,2017,0,0,0,0,0,0
3539202,2017,0,0,0,0,0,0
3539301,2017,151,"2,1",57,"0,8",94,"1,3"
3539400,2017,28,"2,2",25,"1,9",3,"0,2"
3539509,2017,50,"1,3",32,"0,9",18,"0,5"
3539608,2017,0,0,0,0,0,0
3539707,2017,0,0,0,0,0,0
3539806,2017,35,"0,3",35,"0,3",0,0
3539905,2017,0,0,0,0,0,0
3540002,2017,42,2,36,"1,7",6,"0,3"
3540101,2017,0,0,0,0,0,0
3540200,2017,45,1,29,"0,6",16,"0,3"
3540259,2017,0,0,0,0,0,0
3540309,2017,0,0,0,0,0,0
3540408,2017,18,"4,4",8,2,10,"2,5"
3540507,2017,0,0,0,0,0,0
3540606,2017,51,1,39,"0,8",12,"0,2"
3540705,2017,61,"1,1",33,"0,6",28,"0,5"
3540754,2017,0,0,0,0,0,0
3540804,2017,31,"1,9",28,"1,7",3,"0,2"
3540853,2017,0,0,0,0,0,0
3540903,2017,0,0,0,0,0,0
3541000,2017,192,"0,6",179,"0,6",13,0
3541059,2017,0,0,0,0,0,0
3541109,2017,0,0,0,0,0,0
3541208,2017,51,"3,7",40,"2,9",11,"0,8"
3541307,2017,78,"1,9",68,"1,6",10,"0,2"
3541406,2017,1041,"4,8",680,"3,1",361,"1,7"
3541505,2017,96,"2,5",60,"1,6",36,"0,9"
3541604,2017,58,"1,5",58,"1,5",0,0
3541653,2017,0,0,0,0,0,0
3541703,2017,0,0,0,0,0,0
3541802,2017,0,0,0,0,0,0
3541901,2017,38,"3,1",38,"3,1",0,0
3542008,2017,0,0,0,0,0,0
3542107,2017,0,0,0,0,0,0
3542206,2017,103,"3,6",71,"2,5",32,"1,1"
3542305,2017,0,0,0,0,0,0
3542404,2017,16,"0,8",13,"0,7",3,"0,2"
3542503,2017,0,0,0,0,0,0
3542602,2017,110,2,68,"1,3",42,"0,8"
3542701,2017,0,0,0,0,0,0
3542800,2017,0,0,0,0,0,0
3542909,2017,17,"1,3",11,"0,9",6,"0,5"
3543006,2017,36,2,35,2,1,"0,1"
3543105,2017,0,0,0,0,0,0
3543204,2017,0,0,0,0,0,0
3543238,2017,0,0,0,0,0,0
3543253,2017,0,0,0,0,0,0
3543303,2017,164,"1,4",50,"0,4",114,1
3543402,2017,2157,"3,3",1399,"2,1",758,"1,1"
3543501,2017,0,0,0,0,0,0
3543600,2017,0,0,0,0,0,0
3543709,2017,0,0,0,0,0,0
3543808,2017,23,"2,4",20,2,3,"0,3"
3543907,2017,427,"2,2",238,"1,2",189,1
3544004,2017,42,"1,3",28,"0,8",14,"0,4"
3544103,2017,0,0,0,0,0,0
3544202,2017,36,"3,2",7,"0,6",29,"2,6"
3544251,2017,57,3,57,3,0,0
3544301,2017,14,"1,4",14,"1,4",0,0
3544400,2017,0,0,0,0,0,0
3544509,2017,0,0,0,0,0,0
3544608,2017,0,0,0,0,0,0
3544707,2017,0,0,0,0,0,0
3544806,2017,0,0,0,0,0,0
3544905,2017,29,"2,6",19,"1,7",10,"0,9"
3545001,2017,19,"1,2",17,1,2,"0,1"
3545100,2017,0,0,0,0,0,0
3545159,2017,0,0,0,0,0,0
3545209,2017,125,"1,1",72,"0,6",53,"0,5"
3545308,2017,669,"15,5",389,9,280,"6,5"
3545407,2017,34,"3,8",22,"2,4",12,"1,3"
3545506,2017,0,0,0,0,0,0
3545605,2017,24,"1,6",7,"0,5",17,"1,2"
3545704,2017,0,0,0,0,0,0
3545803,2017,156,"0,8",85,"0,5",71,"0,4"
3546009,2017,0,0,0,0,0,0
3546108,2017,0,0,0,0,0,0
3546207,2017,0,0,0,0,0,0
3546256,2017,0,0,0,0,0,0
3546306,2017,46,"1,4",25,"0,8",21,"0,6"
3546405,2017,100,"2,2",65,"1,4",35,"0,8"
3546504,2017,0,0,0,0,0,0
3546603,2017,70,"2,3",53,"1,7",17,"0,6"
3546702,2017,0,0,0,0,0,0
3546801,2017,101,"1,9",82,"1,5",19,"0,4"
3546900,2017,0,0,0,0,0,0
3547007,2017,6,1,6,1,0,0
3547106,2017,0,0,0,0,0,0
3547205,2017,0,0,0,0,0,0
3547304,2017,35,"0,3",35,"0,3",0,0
3547403,2017,0,0,0,0,0,0
3547502,2017,319,"12,1",296,"11,2",23,"0,9"
3547601,2017,30,"1,2",18,"0,7",12,"0,5"
3547650,2017,0,0,0,0,0,0
3547700,2017,56,"2,8",37,"1,8",19,"0,9"
3547809,2017,1317,"1,9",669,1,648,"0,9"
3547908,2017,21,"3,2",21,"3,2",0,0
3548005,2017,0,0,0,0,0,0
3548054,2017,0,0,0,0,0,0
3548104,2017,0,0,0,0,0,0
3548203,2017,0,0,0,0,0,0
3548302,2017,0,0,0,0,0,0
3548401,2017,0,0,0,0,0,0
3548500,2017,1672,"3,9",852,2,820,"1,9"
3548609,2017,40,"3,8",26,"2,5",14,"1,3"
3548708,2017,1558,"1,9",593,"0,7",965,"1,2"
3548807,2017,571,"3,8",183,"1,2",388,"2,6"
3548906,2017,450,"1,9",231,1,219,"0,9"
3549003,2017,0,0,0,0,0,0
3549102,2017,199,"2,3",94,"1,1",105,"1,2"
3549201,2017,0,0,0,0,0,0
3549250,2017,0,0,0,0,0,0
3549300,2017,0,0,0,0,0,0
3549409,2017,115,"2,3",68,"1,4",47,1
3549508,2017,0,0,0,0,0,0
3549607,2017,0,0,0,0,0,0
3549706,2017,136,"2,6",81,"1,5",55,1
3549805,2017,1856,"4,2",870,2,986,"2,3"
3549904,2017,1534,"2,2",736,"1,1",798,"1,2"
3549953,2017,0,0,0,0,0,0
3550001,2017,26,"2,5",11,1,15,"1,4"
3550100,2017,35,"0,9",31,"0,8",4,"0,1"
3550209,2017,54,"1,7",54,"1,7",0,0
3550308,2017,29203,"2,5",15166,"1,3",14037,"1,2"
3550407,2017,62,"1,9",37,"1,1",25,"0,7"
3550506,2017,0,0,0,0,0,0
3550605,2017,88,1,49,"0,6",39,"0,5"
3550704,2017,101,"1,2",93,"1,1",8,"0,1"
3550803,2017,30,"2,5",26,"2,2",4,"0,3"
3550902,2017,50,"3,4",38,"2,6",12,"0,8"
3551009,2017,283,"0,8",166,"0,5",117,"0,3"
3551108,2017,0,0,0,0,0,0
3551207,2017,0,0,0,0,0,0
3551306,2017,0,0,0,0,0,0
3551405,2017,0,0,0,0,0,0
3551504,2017,58,"1,4",43,1,15,"0,4"
3551603,2017,49,"1,8",33,"1,2",16,"0,6"
3551702,2017,162,"1,4",66,"0,6",96,"0,8"
3551801,2017,0,0,0,0,0,0
3551900,2017,0,0,0,0,0,0
3552007,2017,3,"0,5",3,"0,5",0,0
3552106,2017,70,"1,8",63,"1,6",7,"0,2"
3552205,2017,1455,"2,3",892,"1,4",563,"0,9"
3552304,2017,22,"2,9",20,"2,6",2,"0,3"
3552403,2017,181,"0,7",172,"0,6",9,0
3552502,2017,161,"0,6",67,"0,2",94,"0,3"
3552551,2017,0,0,0,0,0,0
3552601,2017,30,"2,6",11,"0,9",19,"1,6"
3552700,2017,35,"2,3",22,"1,4",13,"0,8"
3552809,2017,495,"1,8",334,"1,2",161,"0,6"
3552908,2017,0,0,0,0,0,0
3553005,2017,29,"2,3",24,"1,9",5,"0,4"
3553104,2017,0,0,0,0,0,0
3553203,2017,4,"0,6",4,"0,6",0,0
3553302,2017,36,"1,6",25,"1,1",11,"0,5"
3553401,2017,72,"2,9",30,"1,2",42,"1,7"
3553500,2017,0,0,0,0,0,0
3553609,2017,24,"1,9",19,"1,5",5,"0,4"
3553658,2017,0,0,0,0,0,0
3553708,2017,124,"2,3",73,"1,3",51,"0,9"
3553807,2017,53,"2,3",32,"1,4",21,"0,9"
3553856,2017,0,0,0,0,0,0
3553906,2017,0,0,0,0,0,0
3553955,2017,0,0,0,0,0,0
3554003,2017,177,"1,5",114,1,63,"0,5"
3554102,2017,493,"1,6",325,"1,1",168,"0,6"
3554201,2017,0,0,0,0,0,0
3554300,2017,58,"2,6",52,"2,4",6,"0,3"
3554409,2017,34,"3,8",30,"3,4",4,"0,4"
3554508,2017,57,"1,4",34,"0,9",23,"0,6"
3554607,2017,0,0,0,0,0,0
3554656,2017,0,0,0,0,0,0
3554706,2017,20,"2,1",13,"1,4",7,"0,7"
3554755,2017,0,0,0,0,0,0
3554805,2017,0,0,0,0,0,0
3554904,2017,0,0,0,0,0,0
3554953,2017,0,0,0,0,0,0
3555000,2017,440,7,373,"5,9",67,"1,1"
3555109,2017,48,"3,2",30,2,18,"1,2"
3555208,2017,0,0,0,0,0,0
3555307,2017,0,0,0,0,0,0
3555356,2017,0,0,0,0,0,0
3555406,2017,81,"0,9",71,"0,8",10,"0,1"
3555505,2017,0,0,0,0,0,0
3555604,2017,0,0,0,0,0,0
3555703,2017,0,0,0,0,0,0
3555802,2017,26,3,24,"2,8",2,"0,2"
3555901,2017,0,0,0,0,0,0
3556008,2017,34,"2,6",13,1,21,"1,6"
3556107,2017,0,0,0,0,0,0
3556206,2017,140,"1,2",46,"0,4",94,"0,8"
3556305,2017,55,"2,3",31,"1,3",24,1
3556354,2017,0,0,0,0,0,0
3556404,2017,50,"1,2",31,"0,8",19,"0,5"
3556453,2017,40,"0,8",0,0,40,"0,8"
3556503,2017,35,"0,3",31,"0,3",4,0
3556602,2017,36,"3,4",0,0,36,"3,4"
3556701,2017,88,"1,2",55,"0,7",33,"0,4"
3556800,2017,48,"2,7",30,"1,7",18,1
3556909,2017,0,0,0,0,0,0
3556958,2017,0,0,0,0,0,0
3557006,2017,172,"1,5",88,"0,8",84,"0,7"
3557105,2017,204,"2,3",115,"1,3",89,1
3557154,2017,0,0,0,0,0,0
3557204,2017,50,"4,1",30,"2,5",20,"1,6"
3557303,2017,0,0,0,0,0,0
3500105,2018,258,"7,6",219,"6,5",39,"1,2"
3500204,2018,0,0,0,0,0,0
3500303,2018,10,"0,3",0,0,10,"0,3"
3500402,2018,0,0,0,0,0,0
3500501,2018,42,"2,3",30,"1,7",12,"0,7"
3500550,2018,0,0,0,0,0,0
3500600,2018,0,0,0,0,0,0
3500709,2018,60,"1,7",38,"1,1",22,"0,6"
3500758,2018,0,0,0,0,0,0
3500808,2018,0,0,0,0,0,0
3500907,2018,0,0,0,0,0,0
3501004,2018,31,2,25,"1,6",6,"0,4"
3501103,2018,22,"5,4",19,"4,7",3,"0,7"
3501152,2018,0,0,0,0,0,0
3501202,2018,0,0,0,0,0,0
3501301,2018,20,"0,8",18,"0,8",2,"0,1"
3501400,2018,0,0,0,0,0,0
3501509,2018,0,0,0,0,0,0
3501608,2018,571,"2,5",205,"0,9",366,"1,6"
3501707,2018,198,"5,1",198,"5,1",0,0
3501806,2018,0,0,0,0,0,0
3501905,2018,383,"5,6",230,"3,3",153,"2,2"
3502002,2018,0,0,0,0,0,0
3502101,2018,127,"2,3",91,"1,6",36,"0,6"
3502200,2018,57,"2,4",54,"2,2",3,"0,1"
3502309,2018,0,0,0,0,0,0
3502408,2018,0,0,0,0,0,0
3502507,2018,104,"2,9",70,2,34,1
3502606,2018,22,"5,2",20,"4,8",2,"0,5"
3502705,2018,51,"2,1",41,"1,7",10,"0,4"
3502754,2018,0,0,0,0,0,0
3502804,2018,367,"1,9",305,"1,6",62,"0,3"
3502903,2018,321,"10,2",0,0,321,"10,2"
3503000,2018,0,0,0,0,0,0
3503109,2018,16,"2,6",16,"2,6",0,0
3503158,2018,0,0,0,0,0,0
3503208,2018,443,2,216,1,227,1
3503307,2018,557,"4,3",262,2,295,"2,3"
3503356,2018,0,0,0,0,0,0
3503406,2018,29,"3,6",18,"2,2",11,"1,4"
3503505,2018,0,0,0,0,0,0
3503604,2018,0,0,0,0,0,0
3503703,2018,25,"2,7",4,"0,4",21,"2,3"
3503802,2018,36,"0,7",0,0,36,"0,7"
3503901,2018,92,"1,1",24,"0,3",68,"0,8"
3503950,2018,0,0,0,0,0,0
3504008,2018,285,"2,8",160,"1,6",125,"1,2"
3504107,2018,192,"1,4",55,"0,4",137,1
3504206,2018,44,3,35,"2,4",9,"0,6"
3504305,2018,0,0,0,0,0,0
3504404,2018,0,0,0,0,0,0
3504503,2018,159,"1,8",95,"1,1",64,"0,7"
3504602,2018,0,0,0,0,0,0
3504701,2018,0,0,0,0,0,0
3504800,2018,0,0,0,0,0,0
3504909,2018,15,"1,4",15,"1,4",0,0
3505005,2018,0,0,0,0,0,0
3505104,2018,0,0,0,0,0,0
3505203,2018,23,"0,7",16,"0,5",7,"0,2"
3505302,2018,91,"2,6",59,"1,7",32,"0,9"
3505351,2018,0,0,0,0,0,0
3505401,2018,0,0,0,0,0,0
3505500,2018,504,"4,3",391,"3,3",113,1
3505609,2018,0,0,0,0,0,0
3505708,2018,429,"1,7",353,"1,4",76,"0,3"
3505807,2018,35,"1,7",28,"1,4",7,"0,3"
3505906,2018,133,"2,2",101,"1,7",32,"0,5"
3506003,2018,1159,"3,2",612,"1,7",547,"1,5"
3506102,2018,140,"1,9",75,1,65,"0,9"
3506201,2018,0,0,0,0,0,0
3506300,2018,23,"2,1",23,"2,1",0,0
3506359,2018,49,"0,8",49,"0,8",0,0
3506409,2018,36,"4,7",36,"4,7",0,0
3506508,2018,168,"1,4",88,"0,7",80,"0,7"
3506607,2018,0,0,0,0,0,0
3506706,2018,13,"0,9",11,"0,8",2,"0,1"
3506805,2018,35,"2,9",29,"2,4",6,"0,5"
3506904,2018,0,0,0,0,0,0
3507001,2018,53,1,36,"0,6",17,"0,3"
3507100,2018,12,"0,5",12,"0,5",0,0
3507159,2018,0,0,0,0,0,0
3507209,2018,0,0,0,0,0,0
3507308,2018,0,0,0,0,0,0
3507407,2018,26,"1,7",16,"1,1",10,"0,7"
3507456,2018,0,0,0,0,0,0
3507506,2018,741,"5,3",541,"3,9",200,"1,4"
3507605,2018,368,"2,3",206,"1,3",162,1
3507704,2018,0,0,0,0,0,0
3507753,2018,0,0,0,0,0,0
3507803,2018,0,0,0,0,0,0
3507902,2018,41,"1,8",35,"1,5",6,"0,3"
3508009,2018,0,0,0,0,0,0
3508108,2018,42,"2,6",22,"1,3",20,"1,2"
3508207,2018,0,0,0,0,0,0
3508306,2018,0,0,0,0,0,0
3508405,2018,15,"0,3",10,"0,2",5,"0,1"
3508504,2018,118,"1,3",68,"0,8",50,"0,6"
3508603,2018,47,"1,5",40,"1,3",7,"0,2"
3508702,2018,62,"3,3",62,"3,3",0,0
3508801,2018,48,"2,8",37,"2,2",11,"0,6"
3508900,2018,0,0,0,0,0,0
3509007,2018,122,"1,2",67,"0,7",55,"0,6"
3509106,2018,0,0,0,0,0,0
3509205,2018,155,"2,1",55,"0,7",100,"1,3"
3509254,2018,0,0,0,0,0,0
3509304,2018,32,"3,2",26,"2,6",6,"0,6"
3509403,2018,140,"5,6",55,"2,2",85,"3,4"
3509452,2018,0,0,0,0,0,0
3509502,2018,2755,"2,4",1322,"1,1",1433,"1,2"
3509601,2018,68,"0,8",68,"0,8",0,0
3509700,2018,201,4,191,"3,8",10,"0,2"
3509809,2018,0,0,0,0,0,0
3509908,2018,0,0,0,0,0,0
3509957,2018,0,0,0,0,0,0
3510005,2018,30,1,25,"0,8",5,"0,2"
3510104,2018,0,0,0,0,0,0
3510153,2018,0,0,0,0,0,0
3510203,2018,58,"1,3",48,1,10,"0,2"
3510302,2018,14,"0,7",14,"0,7",0,0
3510401,2018,87,"1,6",47,"0,9",40,"0,8"
3510500,2018,165,"1,5",111,1,54,"0,5"
3510609,2018,270,"0,7",220,"0,6",50,"0,1"
3510708,2018,31,"2,6",12,1,19,"1,6"
3510807,2018,372,"12,7",356,"12,2",16,"0,5"
3510906,2018,0,0,0,0,0,0
3511003,2018,31,"1,5",30,"1,5",1,0
3511102,2018,533,"4,6",374,"3,2",159,"1,4"
3511201,2018,0,0,0,0,0,0
3511300,2018,50,"5,8",0,0,50,"5,8"
3511409,2018,39,"2,1",32,"1,7",7,"0,4"
3511508,2018,28,"0,6",18,"0,4",10,"0,2"
3511607,2018,30,"1,8",17,1,13,"0,8"
3511706,2018,33,2,26,"1,6",7,"0,4"
3511904,2018,30,"3,7",20,"2,5",10,"1,2"
3512001,2018,47,"2,7",35,2,12,"0,7"
3512100,2018,20,"3,3",20,"3,3",0,0
3512209,2018,52,"1,9",50,"1,9",2,"0,1"
3512308,2018,32,"1,9",32,"1,9",0,0
3512407,2018,0,0,0,0,0,0
3512506,2018,0,0,0,0,0,0
3512605,2018,6,"1,2",6,"1,2",0,0
3512704,2018,0,0,0,0,0,0
3512803,2018,112,"1,6",60,"0,9",52,"0,8"
3512902,2018,0,0,0,0,0,0
3513009,2018,553,"2,3",111,"0,5",442,"1,9"
3513108,2018,15,"0,4",13,"0,4",2,"0,1"
3513207,2018,0,0,0,0,0,0
3513306,2018,0,0,0,0,0,0
3513405,2018,120,"1,5",84,"1,1",36,"0,5"
3513504,2018,118,"0,9",66,"0,5",52,"0,4"
3513603,2018,40,"1,8",25,"1,2",15,"0,7"
3513702,2018,40,"1,2",25,"0,8",15,"0,5"
3513801,2018,634,"1,6",555,"1,4",79,"0,2"
3513850,2018,0,0,0,0,0,0
3513900,2018,186,17,186,17,0,0
3514007,2018,0,0,0,0,0,0
3514106,2018,67,"2,5",47,"1,8",20,"0,8"
3514205,2018,0,0,0,0,0,0
3514304,2018,14,"1,6",14,"1,6",0,0
3514403,2018,143,"3,2",108,"2,4",35,"0,8"
3514502,2018,87,"7,2",77,"6,4",10,"0,8"
3514601,2018,0,0,0,0,0,0
3514700,2018,0,0,0,0,0,0
3514809,2018,2,"0,1",2,"0,1",0,0
3514908,2018,6,"0,4",6,"0,4",0,0
3514924,2018,0,0,0,0,0,0
3514957,2018,0,0,0,0,0,0
3515004,2018,94,"0,4",89,"0,3",5,0
3515103,2018,16,"0,2",16,"0,2",0,0
3515129,2018,0,0,0,0,0,0
3515152,2018,0,0,0,0,0,0
3515186,2018,453,"10,7",361,"8,5",92,"2,2"
3515194,2018,0,0,0,0,0,0
3515202,2018,50,"6,2",45,"5,5",5,"0,6"
3515301,2018,0,0,0,0,0,0
3515350,2018,0,0,0,0,0,0
3515400,2018,20,"1,3",12,"0,8",8,"0,5"
3515509,2018,135,2,84,"1,3",51,"0,8"
3515608,2018,0,0,0,0,0,0
3515657,2018,0,0,0,0,0,0
3515707,2018,189,1,189,1,0,0
3515806,2018,0,0,0,0,0,0
3515905,2018,0,0,0,0,0,0
3516002,2018,47,"3,8",30,"2,4",17,"1,4"
3516101,2018,0,0,0,0,0,0
3516200,2018,736,"2,2",482,"1,4",254,"0,8"
3516309,2018,147,"0,9",98,"0,6",49,"0,3"
3516408,2018,693,"4,7",611,"4,1",82,"0,6"
3516507,2018,0,0,0,0,0,0
3516606,2018,45,"6,8",27,"4,1",18,"2,7"
3516705,2018,312,"7,3",270,"6,3",42,1
3516804,2018,0,0,0,0,0,0
3516853,2018,0,0,0,0,0,0
3516903,2018,32,3,20,"1,9",12,"1,1"
3517000,2018,48,"4,4",36,"3,3",12,"1,1"
3517109,2018,0,0,0,0,0,0
3517208,2018,0,0,0,0,0,0
3517307,2018,0,0,0,0,0,0
3517406,2018,60,"1,5",42,"1,1",18,"0,5"
3517505,2018,0,0,0,0,0,0
3517604,2018,19,"1,1",19,"1,1",0,0
3517703,2018,30,"1,5",22,"1,1",8,"0,4"
3517802,2018,23,"2,7",15,"1,8",8,"0,9"
3517901,2018,0,0,0,0,0,0
3518008,2018,0,0,0,0,0,0
3518107,2018,0,0,0,0,0,0
3518206,2018,74,"2,3",48,"1,5",26,"0,8"
3518305,2018,35,"1,2",29,1,6,"0,2"
3518404,2018,244,"2,1",156,"1,3",88,"0,8"
3518503,2018,0,0,0,0,0,0
3518602,2018,67,"1,7",60,"1,6",7,"0,2"
3518701,2018,336,"1,1",225,"0,7",111,"0,4"
3518800,2018,1996,"1,5",1444,"1,1",552,"0,4"
3518859,2018,0,0,0,0,0,0
3518909,2018,0,0,0,0,0,0
3519006,2018,58,"6,3",58,"6,3",0,0
3519055,2018,0,0,0,0,0,0
3519071,2018,84,"0,4",62,"0,3",22,"0,1"
3519105,2018,30,"2,7",28,"2,5",2,"0,2"
3519204,2018,0,0,0,0,0,0
3519253,2018,0,0,0,0,0,0
3519303,2018,32,"0,9",32,"0,9",0,0
3519402,2018,27,"2,3",9,"0,8",18,"1,5"
3519501,2018,0,0,0,0,0,0
3519600,2018,99,"1,7",46,"0,8",53,"0,9"
3519709,2018,67,"0,9",63,"0,8",4,"0,1"
3519808,2018,0,0,0,0,0,0
3519907,2018,20,"2,5",20,"2,5",0,0
3520004,2018,63,"2,6",0,0,63,"2,6"
3520103,2018,60,"2,1",42,"1,4",18,"0,6"
3520202,2018,15,"1,6",15,"1,6",0,0
3520301,2018,9,"0,3",9,"0,3",0,0
3520400,2018,46,"1,4",46,"1,4",0,0
3520426,2018,0,0,0,0,0,0
3520442,2018,116,"4,5",74,"2,9",42,"1,6"
3520509,2018,337,"1,4",207,"0,9",130,"0,6"
3520608,2018,0,0,0,0,0,0
3520707,2018,36,"9,3",4,1,32,"8,3"
3520806,2018,0,0,0,0,0,0
3520905,2018,49,"3,4",29,2,20,"1,4"
3521002,2018,15,"0,5",15,"0,5",0,0
3521101,2018,0,0,0,0,0,0
3521150,2018,0,0,0,0,0,0
3521200,2018,0,0,0,0,0,0
3521309,2018,49,"3,2",39,"2,5",10,"0,6"
3521408,2018,2,"0,1",2,"0,1",0,0
3521507,2018,0,0,0,0,0,0
3521606,2018,0,0,0,0,0,0
3521705,2018,35,2,35,2,0,0
3521804,2018,35,"1,3",35,"1,3",0,0
3521903,2018,30,"2,1",20,"1,4",10,"0,7"
3522000,2018,0,0,0,0,0,0
3522109,2018,131,"1,4",131,"1,4",0,0
3522158,2018,0,0,0,0,0,0
3522208,2018,583,"3,5",176,"1,1",407,"2,4"
3522307,2018,142,"0,9",100,"0,6",42,"0,3"
3522406,2018,145,"1,6",103,"1,1",42,"0,5"
3522505,2018,294,"1,3",217,"0,9",77,"0,3"
3522604,2018,1041,"14,7",578,"8,1",463,"6,5"
3522653,2018,0,0,0,0,0,0
3522703,2018,76,"1,8",46,"1,1",30,"0,7"
3522802,2018,46,"3,1",27,"1,8",19,"1,3"
3522901,2018,30,"2,2",25,"1,9",5,"0,4"
3523008,2018,0,0,0,0,0,0
3523107,2018,224,"0,6",224,"0,6",0,0
3523206,2018,96,2,78,"1,6",18,"0,4"
3523305,2018,0,0,0,0,0,0
3523404,2018,119,1,60,"0,5",59,"0,5"
3523503,2018,14,"0,7",7,"0,3",7,"0,3"
3523602,2018,25,"1,5",25,"1,5",0,0
3523701,2018,0,0,0,0,0,0
3523800,2018,0,0,0,0,0,0
3523909,2018,458,"2,7",426,"2,6",32,"0,2"
3524006,2018,86,"1,5",48,"0,9",38,"0,7"
3524105,2018,121,3,55,"1,4",66,"1,7"
3524204,2018,17,"2,6",17,"2,6",0,0
3524303,2018,212,"2,9",56,"0,8",156,"2,1"
3524402,2018,395,"1,8",167,"0,7",228,1
3524501,2018,216,"32,2",150,"22,3",66,"9,8"
3524600,2018,0,0,0,0,0,0
3524709,2018,80,"1,5",78,"1,5",2,0
3524808,2018,154,"3,3",103,"2,2",51,"1,1"
3524907,2018,0,0,0,0,0,0
3525003,2018,14,"0,1",0,0,14,"0,1"
3525102,2018,0,0,0,0,0,0
3525201,2018,49,"1,7",17,"0,6",32,"1,1"
3525300,2018,905,"6,3",715,5,190,"1,3"
3525409,2018,0,0,0,0,0,0
3525508,2018,11,"0,9",11,"0,9",0,0
3525607,2018,0,0,0,0,0,0
3525706,2018,53,"1,5",22,"0,6",31,"0,9"
3525805,2018,0,0,0,0,0,0
3525854,2018,0,0,0,0,0,0
3525904,2018,824,"2,1",439,"1,1",385,1
3526001,2018,52,"2,6",25,"1,3",27,"1,4"
3526100,2018,0,0,0,0,0,0
3526209,2018,59,2,0,0,59,2
3526308,2018,0,0,0,0,0,0
3526407,2018,46,"1,7",28,1,18,"0,7"
3526506,2018,0,0,0,0,0,0
3526605,2018,0,0,0,0,0,0
3526704,2018,141,"1,4",77,"0,8",64,"0,6"
3526803,2018,87,"1,3",60,"0,9",27,"0,4"
3526902,2018,375,"1,3",180,"0,6",195,"0,7"
3527009,2018,0,0,0,0,0,0
3527108,2018,448,6,344,"4,6",104,"1,4"
3527207,2018,164,"1,9",85,1,79,"0,9"
3527256,2018,0,0,0,0,0,0
3527306,2018,34,"0,7",27,"0,6",7,"0,2"
3527405,2018,15,"0,7",10,"0,5",5,"0,2"
3527504,2018,0,0,0,0,0,0
3527603,2018,0,0,0,0,0,0
3527702,2018,3,"0,5",3,"0,5",0,0
3527801,2018,0,0,0,0,0,0
3527900,2018,0,0,0,0,0,0
3528007,2018,31,"1,8",18,"1,1",13,"0,8"
3528106,2018,18,"2,3",15,"1,9",3,"0,4"
3528205,2018,0,0,0,0,0,0
3528304,2018,0,0,0,0,0,0
3528403,2018,0,0,0,0,0,0
3528502,2018,47,"0,5",41,"0,4",6,"0,1"
3528601,2018,0,0,0,0,0,0
3528700,2018,0,0,0,0,0,0
3528809,2018,26,"1,9",22,"1,6",4,"0,3"
3528858,2018,0,0,0,0,0,0
3528908,2018,0,0,0,0,0,0
3529005,2018,875,"3,8",663,"2,9",212,"0,9"
3529104,2018,0,0,0,0,0,0
3529203,2018,35,"1,4",30,"1,2",5,"0,2"
3529302,2018,162,2,92,"1,2",70,"0,9"
3529401,2018,401,"0,9",246,"0,5",155,"0,3"
3529500,2018,0,0,0,0,0,0
3529609,2018,0,0,0,0,0,0
3529658,2018,0,0,0,0,0,0
3529708,2018,66,"3,1",47,"2,2",19,"0,9"
3529807,2018,5,"0,4",5,"0,4",0,0
3529906,2018,0,0,0,0,0,0
3530003,2018,0,0,0,0,0,0
3530102,2018,68,"2,4",68,"2,4",0,0
3530201,2018,0,0,0,0,0,0
3530300,2018,81,"1,4",30,"0,5",51,"0,9"
3530409,2018,0,0,0,0,0,0
3530508,2018,135,2,88,"1,3",47,"0,7"
3530607,2018,898,"2,1",601,"1,4",297,"0,7"
3530706,2018,333,"2,3",154,"1,1",179,"1,2"
3530805,2018,213,"2,4",114,"1,3",99,"1,1"
3530904,2018,0,0,0,0,0,0
3531001,2018,0,0,0,0,0,0
3531100,2018,48,"0,9",48,"0,9",0,0
3531209,2018,0,0,0,0,0,0
3531308,2018,109,"2,3",58,"1,2",51,"1,1"
3531407,2018,80,"3,5",30,"1,3",50,"2,2"
3531506,2018,70,"3,8",51,"2,8",19,1
3531605,2018,0,0,0,0,0,0
3531704,2018,0,0,0,0,0,0
3531803,2018,35,"0,6",26,"0,5",9,"0,2"
3531902,2018,45,"1,4",31,1,14,"0,4"
3532009,2018,19,"1,5",9,"0,7",10,"0,8"
3532058,2018,0,0,0,0,0,0
3532108,2018,0,0,0,0,0,0
3532157,2018,0,0,0,0,0,0
3532207,2018,0,0,0,0,0,0
3532306,2018,0,0,0,0,0,0
3532405,2018,20,"1,1",20,"1,1",0,0
3532504,2018,21,"2,4",10,"1,2",11,"1,3"
3532603,2018,129,12,35,"3,2",94,"8,7"
3532702,2018,0,0,0,0,0,0
3532801,2018,0,0,0,0,0,0
3532827,2018,0,0,0,0,0,0
3532843,2018,0,0,0,0,0,0
3532868,2018,0,0,0,0,0,0
3532900,2018,12,"1,1",7,"0,7",5,"0,5"
3533007,2018,62,3,19,"0,9",43,"2,1"
3533106,2018,0,0,0,0,0,0
3533205,2018,0,0,0,0,0,0
3533254,2018,0,0,0,0,0,0
3533304,2018,0,0,0,0,0,0
3533403,2018,53,"0,9",53,"0,9",0,0
3533502,2018,105,"2,7",35,"0,9",70,"1,8"
3533601,2018,0,0,0,0,0,0
3533700,2018,0,0,0,0,0,0
3533809,2018,0,0,0,0,0,0
3533908,2018,79,"1,5",42,"0,8",37,"0,7"
3534005,2018,0,0,0,0,0,0
3534104,2018,0,0,0,0,0,0
3534203,2018,0,0,0,0,0,0
3534302,2018,98,"2,3",60,"1,4",38,"0,9"
3534401,2018,916,"1,4",589,"0,9",327,"0,5"
3534500,2018,0,0,0,0,0,0
3534609,2018,73,"2,3",59,"1,9",14,"0,4"
3534708,2018,166,"1,5",83,"0,8",83,"0,8"
3534757,2018,33,"3,5",28,"2,9",5,"0,5"
3534807,2018,0,0,0,0,0,0
3534906,2018,37,"2,8",32,"2,4",5,"0,4"
3535002,2018,0,0,0,0,0,0
3535101,2018,0,0,0,0,0,0
3535200,2018,20,"2,2",10,"1,1",10,"1,1"
3535309,2018,54,"2,5",36,"1,7",18,"0,8"
3535408,2018,36,"2,4",35,"2,3",1,"0,1"
3535507,2018,97,"2,2",78,"1,8",19,"0,4"
3535606,2018,0,0,0,0,0,0
3535705,2018,0,0,0,0,0,0
3535804,2018,30,"1,5",30,"1,5",0,0
3535903,2018,0,0,0,0,0,0
3536000,2018,32,3,26,"2,5",6,"0,6"
3536109,2018,0,0,0,0,0,0
3536208,2018,150,"7,9",150,"7,9",0,0
3536257,2018,0,0,0,0,0,0
3536307,2018,35,"2,5",23,"1,6",12,"0,8"
3536406,2018,0,0,0,0,0,0
3536505,2018,85,"0,8",85,"0,8",0,0
3536570,2018,0,0,0,0,0,0
3536604,2018,24,"2,8",18,"2,1",6,"0,7"
3536703,2018,72,"1,6",52,"1,2",20,"0,4"
3536802,2018,0,0,0,0,0,0
3536901,2018,0,0,0,0,0,0
3537008,2018,82,"5,1",59,"3,6",23,"1,4"
3537107,2018,98,"2,1",98,"2,1",0,0
3537156,2018,0,0,0,0,0,0
3537206,2018,0,0,0,0,0,0
3537305,2018,254,"4,2",175,"2,9",79,"1,3"
3537404,2018,52,"2,1",47,"1,9",5,"0,2"
3537503,2018,0,0,0,0,0,0
3537602,2018,14,"0,2",14,"0,2",0,0
3537701,2018,0,0,0,0,0,0
3537800,2018,290,"5,4",258,"4,8",32,"0,6"
3537909,2018,35,"1,3",27,1,8,"0,3"
3538006,2018,201,"1,3",127,"0,8",74,"0,5"
3538105,2018,0,0,0,0,0,0
3538204,2018,0,0,0,0,0,0
3538303,2018,0,0,0,0,0,0
3538501,2018,0,0,0,0,0,0
3538600,2018,37,"1,4",29,"1,1",8,"0,3"
3538709,2018,757,2,331,"0,9",426,"1,1"
3538808,2018,77,"2,7",58,2,19,"0,7"
3538907,2018,299,"12,9",78,"3,4",221,"9,5"
3539004,2018,41,"3,8",9,"0,8",32,3
3539103,2018,0,0,0,0,0,0
3539202,2018,0,0,0,0,0,0
3539301,2018,151,"2,1",57,"0,8",94,"1,3"
3539400,2018,28,"2,2",25,"1,9",3,"0,2"
3539509,2018,50,"1,3",32,"0,8",18,"0,5"
3539608,2018,0,0,0,0,0,0
3539707,2018,0,0,0,0,0,0
3539806,2018,35,"0,3",35,"0,3",0,0
3539905,2018,0,0,0,0,0,0
3540002,2018,42,2,36,"1,7",6,"0,3"
3540101,2018,0,0,0,0,0,0
3540200,2018,45,"0,9",29,"0,6",16,"0,3"
3540259,2018,0,0,0,0,0,0
3540309,2018,0,0,0,0,0,0
3540408,2018,18,"4,5",8,2,10,"2,5"
3540507,2018,0,0,0,0,0,0
3540606,2018,51,1,39,"0,8",12,"0,2"
3540705,2018,55,1,33,"0,6",22,"0,4"
3540754,2018,0,0,0,0,0,0
3540804,2018,31,"1,9",28,"1,7",3,"0,2"
3540853,2018,0,0,0,0,0,0
3540903,2018,0,0,0,0,0,0
3541000,2018,212,"0,7",199,"0,6",13,0
3541059,2018,0,0,0,0,0,0
3541109,2018,120,"29,7",0,0,120,"29,7"
3541208,2018,51,"3,7",40,"2,9",11,"0,8"
3541307,2018,78,"1,8",68,"1,6",10,"0,2"
3541406,2018,1028,"4,7",676,"3,1",352,"1,6"
3541505,2018,96,"2,5",60,"1,6",36,"0,9"
3541604,2018,45,"1,2",45,"1,2",0,0
3541653,2018,0,0,0,0,0,0
3541703,2018,0,0,0,0,0,0
3541802,2018,0,0,0,0,0,0
3541901,2018,38,"3,1",38,"3,1",0,0
3542008,2018,0,0,0,0,0,0
3542107,2018,0,0,0,0,0,0
3542206,2018,103,"3,6",71,"2,5",32,"1,1"
3542305,2018,0,0,0,0,0,0
3542404,2018,16,"0,8",13,"0,7",3,"0,2"
3542503,2018,0,0,0,0,0,0
3542602,2018,145,"2,7",98,"1,8",47,"0,9"
3542701,2018,0,0,0,0,0,0
3542800,2018,0,0,0,0,0,0
3542909,2018,17,"1,3",11,"0,9",6,"0,5"
3543006,2018,36,2,35,2,1,"0,1"
3543105,2018,0,0,0,0,0,0
3543204,2018,0,0,0,0,0,0
3543238,2018,0,0,0,0,0,0
3543253,2018,0,0,0,0,0,0
3543303,2018,164,"1,4",50,"0,4",114,1
3543402,2018,2188,"3,3",1415,"2,1",773,"1,2"
3543501,2018,0,0,0,0,0,0
3543600,2018,0,0,0,0,0,0
3543709,2018,0,0,0,0,0,0
3543808,2018,23,"2,4",20,2,3,"0,3"
3543907,2018,392,2,190,1,202,1
3544004,2018,44,"1,3",32,1,12,"0,4"
3544103,2018,0,0,0,0,0,0
3544202,2018,36,"3,2",7,"0,6",29,"2,6"
3544251,2018,57,"3,1",57,"3,1",0,0
3544301,2018,54,"5,2",14,"1,3",40,"3,8"
3544400,2018,0,0,0,0,0,0
3544509,2018,0,0,0,0,0,0
3544608,2018,0,0,0,0,0,0
3544707,2018,0,0,0,0,0,0
3544806,2018,0,0,0,0,0,0
3544905,2018,29,"2,6",19,"1,7",10,"0,9"
3545001,2018,19,"1,1",17,1,2,"0,1"
3545100,2018,0,0,0,0,0,0
3545159,2018,0,0,0,0,0,0
3545209,2018,116,1,62,"0,5",54,"0,5"
3545308,2018,269,"6,2",247,"5,7",22,"0,5"
3545407,2018,34,"3,8",22,"2,4",12,"1,3"
3545506,2018,0,0,0,0,0,0
3545605,2018,24,"1,6",7,"0,5",17,"1,1"
3545704,2018,0,0,0,0,0,0
3545803,2018,168,"0,9",97,"0,5",71,"0,4"
3546009,2018,0,0,0,0,0,0
3546108,2018,0,0,0,0,0,0
3546207,2018,0,0,0,0,0,0
3546256,2018,0,0,0,0,0,0
3546306,2018,46,"1,4",25,"0,8",21,"0,6"
3546405,2018,96,"2,1",55,"1,2",41,"0,9"
3546504,2018,0,0,0,0,0,0
3546603,2018,70,"2,3",46,"1,5",24,"0,8"
3546702,2018,0,0,0,0,0,0
3546801,2018,101,"1,9",82,"1,5",19,"0,4"
3546900,2018,0,0,0,0,0,0
3547007,2018,6,1,6,1,0,0
3547106,2018,0,0,0,0,0,0
3547205,2018,0,0,0,0,0,0
3547304,2018,35,"0,3",35,"0,3",0,0
3547403,2018,0,0,0,0,0,0
3547502,2018,319,"12,1",296,"11,2",23,"0,9"
3547601,2018,30,"1,2",18,"0,7",12,"0,5"
3547650,2018,0,0,0,0,0,0
3547700,2018,56,"2,8",37,"1,8",19,"0,9"
3547809,2018,1455,"2,1",643,"0,9",812,"1,2"
3547908,2018,21,"3,2",21,"3,2",0,0
3548005,2018,0,0,0,0,0,0
3548054,2018,0,0,0,0,0,0
3548104,2018,0,0,0,0,0,0
3548203,2018,0,0,0,0,0,0
3548302,2018,0,0,0,0,0,0
3548401,2018,0,0,0,0,0,0
3548500,2018,1738,"4,1",874,2,864,2
3548609,2018,40,"3,8",26,"2,5",14,"1,3"
3548708,2018,1510,"1,9",785,1,725,"0,9"
3548807,2018,591,"3,9",183,"1,2",408,"2,7"
3548906,2018,434,"1,8",213,"0,9",221,"0,9"
3549003,2018,0,0,0,0,0,0
3549102,2018,199,"2,3",94,"1,1",105,"1,2"
3549201,2018,0,0,0,0,0,0
3549250,2018,0,0,0,0,0,0
3549300,2018,0,0,0,0,0,0
3549409,2018,115,"2,3",68,"1,4",47,"0,9"
3549508,2018,0,0,0,0,0,0
3549607,2018,0,0,0,0,0,0
3549706,2018,136,"2,6",81,"1,5",55,1
3549805,2018,1850,"4,2",871,2,979,"2,2"
3549904,2018,1645,"2,4",869,"1,3",776,"1,1"
3549953,2018,0,0,0,0,0,0
3550001,2018,26,"2,5",11,1,15,"1,4"
3550100,2018,35,"0,9",31,"0,8",4,"0,1"
3550209,2018,54,"1,7",54,"1,7",0,0
3550308,2018,29203,"2,5",14846,"1,3",14357,"1,2"
3550407,2018,62,"1,8",37,"1,1",25,"0,7"
3550506,2018,0,0,0,0,0,0
3550605,2018,88,1,49,"0,6",39,"0,5"
3550704,2018,101,"1,2",93,"1,1",8,"0,1"
3550803,2018,30,"2,5",26,"2,2",4,"0,3"
3550902,2018,50,"3,4",38,"2,6",12,"0,8"
3551009,2018,281,"0,8",150,"0,4",131,"0,4"
3551108,2018,0,0,0,0,0,0
3551207,2018,0,0,0,0,0,0
3551306,2018,0,0,0,0,0,0
3551405,2018,0,0,0,0,0,0
3551504,2018,55,"1,3",42,1,13,"0,3"
3551603,2018,49,"1,8",33,"1,2",16,"0,6"
3551702,2018,162,"1,3",66,"0,5",96,"0,8"
3551801,2018,0,0,0,0,0,0
3551900,2018,0,0,0,0,0,0
3552007,2018,2,"0,3",2,"0,3",0,0
3552106,2018,70,"1,8",63,"1,6",7,"0,2"
3552205,2018,1414,"2,2",845,"1,3",569,"0,9"
3552304,2018,22,"2,9",20,"2,6",2,"0,3"
3552403,2018,177,"0,6",172,"0,6",5,0
3552502,2018,150,"0,5",67,"0,2",83,"0,3"
3552551,2018,0,0,0,0,0,0
3552601,2018,30,"2,5",11,"0,9",19,"1,6"
3552700,2018,35,"2,2",22,"1,4",13,"0,8"
3552809,2018,495,"1,8",334,"1,2",161,"0,6"
3552908,2018,0,0,0,0,0,0
3553005,2018,29,"2,3",24,"1,9",5,"0,4"
3553104,2018,0,0,0,0,0,0
3553203,2018,4,"0,6",4,"0,6",0,0
3553302,2018,36,"1,6",25,"1,1",11,"0,5"
3553401,2018,72,"2,9",30,"1,2",42,"1,7"
3553500,2018,0,0,0,0,0,0
3553609,2018,24,"1,9",19,"1,5",5,"0,4"
3553658,2018,0,0,0,0,0,0
3553708,2018,124,"2,3",72,"1,3",52,1
3553807,2018,49,"2,1",31,"1,3",18,"0,8"
3553856,2018,0,0,0,0,0,0
3553906,2018,0,0,0,0,0,0
3553955,2018,0,0,0,0,0,0
3554003,2018,147,"1,3",92,"0,8",55,"0,5"
3554102,2018,504,"1,7",325,"1,1",179,"0,6"
3554201,2018,0,0,0,0,0,0
3554300,2018,58,"2,6",52,"2,3",6,"0,3"
3554409,2018,34,"3,8",30,"3,3",4,"0,4"
3554508,2018,55,"1,4",33,"0,8",22,"0,5"
3554607,2018,0,0,0,0,0,0
3554656,2018,0,0,0,0,0,0
3554706,2018,20,"2,1",13,"1,3",7,"0,7"
3554755,2018,0,0,0,0,0,0
3554805,2018,0,0,0,0,0,0
3554904,2018,0,0,0,0,0,0
3554953,2018,0,0,0,0,0,0
3555000,2018,446,"7,1",330,"5,2",116,"1,8"
3555109,2018,48,"3,2",30,2,18,"1,2"
3555208,2018,0,0,0,0,0,0
3555307,2018,0,0,0,0,0,0
3555356,2018,0,0,0,0,0,0
3555406,2018,81,"0,9",71,"0,8",10,"0,1"
3555505,2018,0,0,0,0,0,0
3555604,2018,0,0,0,0,0,0
3555703,2018,0,0,0,0,0,0
3555802,2018,26,3,24,"2,8",2,"0,2"
3555901,2018,0,0,0,0,0,0
3556008,2018,34,"2,6",13,1,21,"1,6"
3556107,2018,0,0,0,0,0,0
3556206,2018,142,"1,2",57,"0,5",85,"0,7"
3556305,2018,55,"2,3",31,"1,3",24,1
3556354,2018,0,0,0,0,0,0
3556404,2018,77,"1,9",47,"1,1",30,"0,7"
3556453,2018,70,"1,4",2,0,68,"1,3"
3556503,2018,39,"0,3",31,"0,3",8,"0,1"
3556602,2018,72,"6,8",0,0,72,"6,8"
3556701,2018,78,1,49,"0,7",29,"0,4"
3556800,2018,48,"2,6",30,"1,7",18,1
3556909,2018,0,0,0,0,0,0
3556958,2018,0,0,0,0,0,0
3557006,2018,177,"1,5",53,"0,5",124,"1,1"
3557105,2018,205,"2,3",115,"1,3",90,1
3557154,2018,0,0,0,0,0,0
3557204,2018,50,"4,1",30,"2,5",20,"1,6"
3557303,2018,0,0,0,0,0,0
3500105,2019,235,"6,9",206,"6,1",29,"0,9"
3500204,2019,0,0,0,0,0,0
3500303,2019,0,0,0,0,0,0
3500402,2019,0,0,0,0,0,0
3500501,2019,42,"2,3",30,"1,6",12,"0,7"
3500550,2019,0,0,0,0,0,0
3500600,2019,0,0,0,0,0,0
3500709,2019,60,"1,7",38,"1,1",22,"0,6"
3500758,2019,0,0,0,0,0,0
3500808,2019,0,0,0,0,0,0
3500907,2019,0,0,0,0,0,0
3501004,2019,31,2,25,"1,6",6,"0,4"
3501103,2019,22,"5,5",19,"4,7",3,"0,7"
3501152,2019,0,0,0,0,0,0
3501202,2019,0,0,0,0,0,0
3501301,2019,20,"0,8",18,"0,8",2,"0,1"
3501400,2019,0,0,0,0,0,0
3501509,2019,0,0,0,0,0,0
3501608,2019,517,"2,2",207,"0,9",310,"1,3"
3501707,2019,177,"4,5",177,"4,5",0,0
3501806,2019,0,0,0,0,0,0
3501905,2019,392,"5,7",215,"3,1",177,"2,6"
3502002,2019,0,0,0,0,0,0
3502101,2019,127,"2,3",91,"1,6",36,"0,6"
3502200,2019,57,"2,3",54,"2,2",3,"0,1"
3502309,2019,0,0,0,0,0,0
3502408,2019,0,0,0,0,0,0
3502507,2019,104,"2,9",70,2,34,1
3502606,2019,22,"5,3",20,"4,8",2,"0,5"
3502705,2019,45,"1,8",39,"1,6",6,"0,2"
3502754,2019,0,0,0,0,0,0
3502804,2019,435,"2,3",305,"1,6",130,"0,7"
3502903,2019,321,"10,1",0,0,321,"10,1"
3503000,2019,0,0,0,0,0,0
3503109,2019,12,"1,9",12,"1,9",0,0
3503158,2019,0,0,0,0,0,0
3503208,2019,442,2,222,1,220,1
3503307,2019,503,"3,9",246,"1,9",257,2
3503356,2019,0,0,0,0,0,0
3503406,2019,29,"3,6",18,"2,2",11,"1,3"
3503505,2019,0,0,0,0,0,0
3503604,2019,0,0,0,0,0,0
3503703,2019,0,0,0,0,0,0
3503802,2019,36,"0,7",0,0,36,"0,7"
3503901,2019,92,1,24,"0,3",68,"0,8"
3503950,2019,0,0,0,0,0,0
3504008,2019,285,"2,8",160,"1,6",125,"1,2"
3504107,2019,192,"1,4",55,"0,4",137,1
3504206,2019,44,3,35,"2,4",9,"0,6"
3504305,2019,0,0,0,0,0,0
3504404,2019,0,0,0,0,0,0
3504503,2019,159,"1,8",95,"1,1",64,"0,7"
3504602,2019,0,0,0,0,0,0
3504701,2019,0,0,0,0,0,0
3504800,2019,0,0,0,0,0,0
3504909,2019,15,"1,4",15,"1,4",0,0
3505005,2019,0,0,0,0,0,0
3505104,2019,0,0,0,0,0,0
3505203,2019,51,"1,5",34,1,17,"0,5"
3505302,2019,91,"2,6",59,"1,7",32,"0,9"
3505351,2019,0,0,0,0,0,0
3505401,2019,0,0,0,0,0,0
3505500,2019,504,"4,3",391,"3,3",113,1
3505609,2019,0,0,0,0,0,0
3505708,2019,431,"1,6",355,"1,4",76,"0,3"
3505807,2019,35,"1,7",28,"1,4",7,"0,3"
3505906,2019,133,"2,2",101,"1,7",32,"0,5"
3506003,2019,1228,"3,4",636,"1,8",592,"1,6"
3506102,2019,140,"1,9",75,1,65,"0,9"
3506201,2019,0,0,0,0,0,0
3506300,2019,23,"2,1",23,"2,1",0,0
3506359,2019,49,"0,8",49,"0,8",0,0
3506409,2019,36,"4,6",35,"4,5",1,"0,1"
3506508,2019,146,"1,2",66,"0,5",80,"0,7"
3506607,2019,0,0,0,0,0,0
3506706,2019,14,1,13,"0,9",1,"0,1"
3506805,2019,35,"2,9",29,"2,4",6,"0,5"
3506904,2019,0,0,0,0,0,0
3507001,2019,54,1,36,"0,6",18,"0,3"
3507100,2019,12,"0,5",12,"0,5",0,0
3507159,2019,0,0,0,0,0,0
3507209,2019,0,0,0,0,0,0
3507308,2019,0,0,0,0,0,0
3507407,2019,26,"1,7",16,1,10,"0,7"
3507456,2019,0,0,0,0,0,0
3507506,2019,644,"4,6",541,"3,9",103,"0,7"
3507605,2019,372,"2,3",206,"1,3",166,1
3507704,2019,0,0,0,0,0,0
3507753,2019,0,0,0,0,0,0
3507803,2019,0,0,0,0,0,0
3507902,2019,41,"1,7",35,"1,5",6,"0,3"
3508009,2019,0,0,0,0,0,0
3508108,2019,42,"2,5",22,"1,3",20,"1,2"
3508207,2019,0,0,0,0,0,0
3508306,2019,0,0,0,0,0,0
3508405,2019,15,"0,3",10,"0,2",5,"0,1"
3508504,2019,178,2,63,"0,7",115,"1,3"
3508603,2019,16,"0,5",14,"0,4",2,"0,1"
3508702,2019,62,"3,3",62,"3,3",0,0
3508801,2019,48,"2,8",37,"2,2",11,"0,6"
3508900,2019,0,0,0,0,0,0
3509007,2019,110,"1,1",65,"0,7",45,"0,5"
3509106,2019,0,0,0,0,0,0
3509205,2019,149,2,49,"0,6",100,"1,3"
3509254,2019,0,0,0,0,0,0
3509304,2019,32,"3,2",26,"2,6",6,"0,6"
3509403,2019,140,"5,5",55,"2,2",85,"3,3"
3509452,2019,0,0,0,0,0,0
3509502,2019,2578,"2,2",1316,"1,1",1262,"1,1"
3509601,2019,68,"0,8",68,"0,8",0,0
3509700,2019,201,4,191,"3,8",10,"0,2"
3509809,2019,0,0,0,0,0,0
3509908,2019,0,0,0,0,0,0
3509957,2019,0,0,0,0,0,0
3510005,2019,30,1,25,"0,8",5,"0,2"
3510104,2019,0,0,0,0,0,0
3510153,2019,0,0,0,0,0,0
3510203,2019,58,"1,3",48,1,10,"0,2"
3510302,2019,59,"2,9",14,"0,7",45,"2,2"
3510401,2019,93,"1,7",47,"0,9",46,"0,9"
3510500,2019,165,"1,4",111,1,54,"0,5"
3510609,2019,270,"0,7",220,"0,6",50,"0,1"
3510708,2019,31,"2,6",12,1,19,"1,6"
3510807,2019,372,"12,7",356,"12,1",16,"0,5"
3510906,2019,0,0,0,0,0,0
3511003,2019,31,"1,5",30,"1,5",1,0
3511102,2019,588,5,374,"3,2",214,"1,8"
3511201,2019,0,0,0,0,0,0
3511300,2019,50,"5,7",0,0,50,"5,7"
3511409,2019,39,2,32,"1,7",7,"0,4"
3511508,2019,32,"0,7",21,"0,5",11,"0,2"
3511607,2019,22,"1,3",17,1,5,"0,3"
3511706,2019,33,2,26,"1,6",7,"0,4"
3511904,2019,30,"3,7",20,"2,4",10,"1,2"
3512001,2019,47,"2,7",35,2,12,"0,7"
3512100,2019,20,"3,3",20,"3,3",0,0
3512209,2019,52,"1,9",42,"1,6",10,"0,4"
3512308,2019,32,"1,9",32,"1,9",0,0
3512407,2019,0,0,0,0,0,0
3512506,2019,0,0,0,0,0,0
3512605,2019,6,"1,2",6,"1,2",0,0
3512704,2019,0,0,0,0,0,0
3512803,2019,68,1,33,"0,5",35,"0,5"
3512902,2019,0,0,0,0,0,0
3513009,2019,667,"2,7",111,"0,5",556,"2,3"
3513108,2019,15,"0,4",13,"0,4",2,"0,1"
3513207,2019,0,0,0,0,0,0
3513306,2019,0,0,0,0,0,0
3513405,2019,103,"1,3",67,"0,8",36,"0,5"
3513504,2019,118,"0,9",66,"0,5",52,"0,4"
3513603,2019,40,"1,8",25,"1,2",15,"0,7"
3513702,2019,40,"1,2",25,"0,8",15,"0,5"
3513801,2019,624,"1,5",555,"1,4",69,"0,2"
3513850,2019,0,0,0,0,0,0
3513900,2019,186,17,186,17,0,0
3514007,2019,0,0,0,0,0,0
3514106,2019,67,"2,5",47,"1,8",20,"0,7"
3514205,2019,0,0,0,0,0,0
3514304,2019,14,"1,6",14,"1,6",0,0
3514403,2019,143,"3,2",108,"2,4",35,"0,8"
3514502,2019,87,"7,2",77,"6,4",10,"0,8"
3514601,2019,0,0,0,0,0,0
3514700,2019,0,0,0,0,0,0
3514809,2019,2,"0,1",2,"0,1",0,0
3514908,2019,6,"0,3",6,"0,3",0,0
3514924,2019,0,0,0,0,0,0
3514957,2019,0,0,0,0,0,0
3515004,2019,244,"0,9",89,"0,3",155,"0,6"
3515103,2019,17,"0,3",17,"0,3",0,0
3515129,2019,0,0,0,0,0,0
3515152,2019,0,0,0,0,0,0
3515186,2019,452,"10,6",354,"8,3",98,"2,3"
3515194,2019,0,0,0,0,0,0
3515202,2019,66,"8,1",61,"7,5",5,"0,6"
3515301,2019,0,0,0,0,0,0
3515350,2019,0,0,0,0,0,0
3515400,2019,20,"1,3",12,"0,8",8,"0,5"
3515509,2019,135,2,84,"1,3",51,"0,8"
3515608,2019,0,0,0,0,0,0
3515657,2019,0,0,0,0,0,0
3515707,2019,189,1,189,1,0,0
3515806,2019,0,0,0,0,0,0
3515905,2019,0,0,0,0,0,0
3516002,2019,47,"3,9",30,"2,5",17,"1,4"
3516101,2019,0,0,0,0,0,0
3516200,2019,739,"2,2",488,"1,4",251,"0,7"
3516309,2019,98,"0,6",98,"0,6",0,0
3516408,2019,693,"4,6",611,"4,1",82,"0,5"
3516507,2019,0,0,0,0,0,0
3516606,2019,45,"6,8",27,"4,1",18,"2,7"
3516705,2019,281,"6,6",252,"5,9",29,"0,7"
3516804,2019,0,0,0,0,0,0
3516853,2019,0,0,0,0,0,0
3516903,2019,32,3,20,"1,9",12,"1,1"
3517000,2019,48,"4,4",36,"3,3",12,"1,1"
3517109,2019,0,0,0,0,0,0
3517208,2019,0,0,0,0,0,0
3517307,2019,0,0,0,0,0,0
3517406,2019,60,"1,5",42,"1,1",18,"0,5"
3517505,2019,0,0,0,0,0,0
3517604,2019,27,"1,5",27,"1,5",0,0
3517703,2019,50,"2,4",40,"1,9",10,"0,5"
3517802,2019,23,"2,7",15,"1,8",8,1
3517901,2019,0,0,0,0,0,0
3518008,2019,0,0,0,0,0,0
3518107,2019,0,0,0,0,0,0
3518206,2019,74,"2,3",48,"1,5",26,"0,8"
3518305,2019,35,"1,2",29,1,6,"0,2"
3518404,2019,265,"2,3",156,"1,3",109,"0,9"
3518503,2019,0,0,0,0,0,0
3518602,2019,66,"1,7",59,"1,5",7,"0,2"
3518701,2019,336,"1,1",225,"0,7",111,"0,4"
3518800,2019,1987,"1,5",1444,"1,1",543,"0,4"
3518859,2019,0,0,0,0,0,0
3518909,2019,0,0,0,0,0,0
3519006,2019,58,"6,3",58,"6,3",0,0
3519055,2019,0,0,0,0,0,0
3519071,2019,100,"0,4",78,"0,3",22,"0,1"
3519105,2019,30,"2,7",28,"2,5",2,"0,2"
3519204,2019,0,0,0,0,0,0
3519253,2019,0,0,0,0,0,0
3519303,2019,27,"0,8",27,"0,8",0,0
3519402,2019,27,"2,3",9,"0,8",18,"1,5"
3519501,2019,0,0,0,0,0,0
3519600,2019,103,"1,8",46,"0,8",57,1
3519709,2019,172,"2,3",63,"0,8",109,"1,4"
3519808,2019,0,0,0,0,0,0
3519907,2019,18,"2,3",18,"2,3",0,0
3520004,2019,0,0,0,0,0,0
3520103,2019,60,2,42,"1,4",18,"0,6"
3520202,2019,8,"0,9",8,"0,9",0,0
3520301,2019,9,"0,3",9,"0,3",0,0
3520400,2019,51,"1,5",51,"1,5",0,0
3520426,2019,0,0,0,0,0,0
3520442,2019,116,"4,5",74,"2,9",42,"1,6"
3520509,2019,350,"1,5",207,"0,9",143,"0,6"
3520608,2019,0,0,0,0,0,0
3520707,2019,36,"9,3",4,1,32,"8,3"
3520806,2019,0,0,0,0,0,0
3520905,2019,49,"3,4",29,2,20,"1,4"
3521002,2019,15,"0,4",15,"0,4",0,0
3521101,2019,0,0,0,0,0,0
3521150,2019,0,0,0,0,0,0
3521200,2019,0,0,0,0,0,0
3521309,2019,49,"3,1",39,"2,5",10,"0,6"
3521408,2019,3,"0,1",3,"0,1",0,0
3521507,2019,0,0,0,0,0,0
3521606,2019,0,0,0,0,0,0
3521705,2019,19,"1,1",19,"1,1",0,0
3521804,2019,35,"1,3",35,"1,3",0,0
3521903,2019,50,"3,4",32,"2,2",18,"1,2"
3522000,2019,0,0,0,0,0,0
3522109,2019,131,"1,3",131,"1,3",0,0
3522158,2019,0,0,0,0,0,0
3522208,2019,583,"3,5",176,1,407,"2,4"
3522307,2019,142,"0,9",100,"0,6",42,"0,3"
3522406,2019,134,"1,5",93,1,41,"0,4"
3522505,2019,307,"1,3",213,"0,9",94,"0,4"
3522604,2019,988,"13,9",576,"8,1",412,"5,8"
3522653,2019,0,0,0,0,0,0
3522703,2019,76,"1,8",46,"1,1",30,"0,7"
3522802,2019,46,"3,1",27,"1,8",19,"1,3"
3522901,2019,30,"2,2",30,"2,2",0,0
3523008,2019,0,0,0,0,0,0
3523107,2019,224,"0,6",224,"0,6",0,0
3523206,2019,80,"1,6",64,"1,3",16,"0,3"
3523305,2019,0,0,0,0,0,0
3523404,2019,119,1,69,"0,6",50,"0,4"
3523503,2019,14,"0,7",7,"0,3",7,"0,3"
3523602,2019,25,"1,5",25,"1,5",0,0
3523701,2019,0,0,0,0,0,0
3523800,2019,0,0,0,0,0,0
3523909,2019,389,"2,3",357,"2,1",32,"0,2"
3524006,2019,86,"1,5",48,"0,8",38,"0,7"
3524105,2019,120,3,53,"1,3",67,"1,7"
3524204,2019,17,"2,5",17,"2,5",0,0
3524303,2019,212,"2,9",56,"0,8",156,"2,1"
3524402,2019,404,"1,8",167,"0,7",237,1
3524501,2019,216,"31,6",149,"21,8",67,"9,8"
3524600,2019,0,0,0,0,0,0
3524709,2019,80,"1,5",78,"1,4",2,0
3524808,2019,151,"3,2",103,"2,2",48,1
3524907,2019,0,0,0,0,0,0
3525003,2019,15,"0,1",0,0,15,"0,1"
3525102,2019,0,0,0,0,0,0
3525201,2019,29,1,17,"0,6",12,"0,4"
3525300,2019,895,"6,1",711,"4,9",184,"1,3"
3525409,2019,0,0,0,0,0,0
3525508,2019,11,"0,9",11,"0,9",0,0
3525607,2019,0,0,0,0,0,0
3525706,2019,53,"1,5",22,"0,6",31,"0,9"
3525805,2019,0,0,0,0,0,0
3525854,2019,0,0,0,0,0,0
3525904,2019,824,2,439,"1,1",385,1
3526001,2019,52,"2,6",25,"1,3",27,"1,4"
3526100,2019,0,0,0,0,0,0
3526209,2019,59,2,0,0,59,2
3526308,2019,0,0,0,0,0,0
3526407,2019,46,"1,7",28,1,18,"0,7"
3526506,2019,0,0,0,0,0,0
3526605,2019,0,0,0,0,0,0
3526704,2019,122,"1,2",77,"0,8",45,"0,4"
3526803,2019,88,"1,3",45,"0,7",43,"0,7"
3526902,2019,377,"1,3",174,"0,6",203,"0,7"
3527009,2019,0,0,0,0,0,0
3527108,2019,428,"5,7",324,"4,3",104,"1,4"
3527207,2019,164,"1,9",85,1,79,"0,9"
3527256,2019,0,0,0,0,0,0
3527306,2019,36,"0,8",31,"0,7",5,"0,1"
3527405,2019,15,"0,7",10,"0,5",5,"0,2"
3527504,2019,0,0,0,0,0,0
3527603,2019,0,0,0,0,0,0
3527702,2019,3,"0,5",3,"0,5",0,0
3527801,2019,0,0,0,0,0,0
3527900,2019,0,0,0,0,0,0
3528007,2019,31,"1,8",18,"1,1",13,"0,8"
3528106,2019,18,"2,3",15,"1,9",3,"0,4"
3528205,2019,0,0,0,0,0,0
3528304,2019,0,0,0,0,0,0
3528403,2019,0,0,0,0,0,0
3528502,2019,47,"0,5",41,"0,4",6,"0,1"
3528601,2019,0,0,0,0,0,0
3528700,2019,0,0,0,0,0,0
3528809,2019,26,"1,9",22,"1,6",4,"0,3"
3528858,2019,0,0,0,0,0,0
3528908,2019,0,0,0,0,0,0
3529005,2019,822,"3,6",618,"2,7",204,"0,9"
3529104,2019,0,0,0,0,0,0
3529203,2019,35,"1,4",30,"1,2",5,"0,2"
3529302,2019,162,2,96,"1,2",66,"0,8"
3529401,2019,402,"0,9",189,"0,4",213,"0,5"
3529500,2019,0,0,0,0,0,0
3529609,2019,0,0,0,0,0,0
3529658,2019,0,0,0,0,0,0
3529708,2019,66,"3,1",47,"2,2",19,"0,9"
3529807,2019,11,"0,9",11,"0,9",0,0
3529906,2019,0,0,0,0,0,0
3530003,2019,0,0,0,0,0,0
3530102,2019,68,"2,4",68,"2,4",0,0
3530201,2019,0,0,0,0,0,0
3530300,2019,81,"1,4",30,"0,5",51,"0,9"
3530409,2019,0,0,0,0,0,0
3530508,2019,135,2,88,"1,3",47,"0,7"
3530607,2019,896,"2,1",600,"1,4",296,"0,7"
3530706,2019,333,"2,3",141,1,192,"1,3"
3530805,2019,213,"2,4",114,"1,3",99,"1,1"
3530904,2019,0,0,0,0,0,0
3531001,2019,0,0,0,0,0,0
3531100,2019,36,"0,7",36,"0,7",0,0
3531209,2019,0,0,0,0,0,0
3531308,2019,109,"2,3",58,"1,2",51,"1,1"
3531407,2019,80,"3,4",30,"1,3",50,"2,1"
3531506,2019,70,"3,8",51,"2,8",19,1
3531605,2019,0,0,0,0,0,0
3531704,2019,0,0,0,0,0,0
3531803,2019,35,"0,6",26,"0,4",9,"0,2"
3531902,2019,45,"1,4",31,1,14,"0,4"
3532009,2019,19,"1,5",9,"0,7",10,"0,8"
3532058,2019,0,0,0,0,0,0
3532108,2019,0,0,0,0,0,0
3532157,2019,0,0,0,0,0,0
3532207,2019,0,0,0,0,0,0
3532306,2019,0,0,0,0,0,0
3532405,2019,20,"1,1",20,"1,1",0,0
3532504,2019,21,"2,4",10,"1,2",11,"1,3"
3532603,2019,129,12,35,"3,2",94,"8,7"
3532702,2019,0,0,0,0,0,0
3532801,2019,0,0,0,0,0,0
3532827,2019,0,0,0,0,0,0
3532843,2019,0,0,0,0,0,0
3532868,2019,0,0,0,0,0,0
3532900,2019,12,"1,1",7,"0,7",5,"0,5"
3533007,2019,62,3,19,"0,9",43,"2,1"
3533106,2019,0,0,0,0,0,0
3533205,2019,0,0,0,0,0,0
3533254,2019,0,0,0,0,0,0
3533304,2019,0,0,0,0,0,0
3533403,2019,53,"0,9",53,"0,9",0,0
3533502,2019,105,"2,7",35,"0,9",70,"1,8"
3533601,2019,0,0,0,0,0,0
3533700,2019,0,0,0,0,0,0
3533809,2019,0,0,0,0,0,0
3533908,2019,79,"1,5",42,"0,8",37,"0,7"
3534005,2019,0,0,0,0,0,0
3534104,2019,0,0,0,0,0,0
3534203,2019,0,0,0,0,0,0
3534302,2019,98,"2,3",60,"1,4",38,"0,9"
3534401,2019,878,"1,3",578,"0,9",300,"0,4"
3534500,2019,0,0,0,0,0,0
3534609,2019,77,"2,5",53,"1,7",24,"0,8"
3534708,2019,166,"1,5",83,"0,8",83,"0,8"
3534757,2019,33,"3,4",28,"2,9",5,"0,5"
3534807,2019,0,0,0,0,0,0
3534906,2019,37,"2,8",32,"2,4",5,"0,4"
3535002,2019,0,0,0,0,0,0
3535101,2019,0,0,0,0,0,0
3535200,2019,20,"2,2",10,"1,1",10,"1,1"
3535309,2019,54,"2,5",36,"1,7",18,"0,8"
3535408,2019,36,"2,4",35,"2,3",1,"0,1"
3535507,2019,97,"2,2",78,"1,8",19,"0,4"
3535606,2019,0,0,0,0,0,0
3535705,2019,0,0,0,0,0,0
3535804,2019,30,"1,5",30,"1,5",0,0
3535903,2019,0,0,0,0,0,0
3536000,2019,32,3,26,"2,5",6,"0,6"
3536109,2019,0,0,0,0,0,0
3536208,2019,150,"7,8",150,"7,8",0,0
3536257,2019,0,0,0,0,0,0
3536307,2019,35,"2,4",23,"1,6",12,"0,8"
3536406,2019,0,0,0,0,0,0
3536505,2019,97,"0,9",97,"0,9",0,0
3536570,2019,0,0,0,0,0,0
3536604,2019,24,"2,8",18,"2,1",6,"0,7"
3536703,2019,72,"1,6",52,"1,2",20,"0,4"
3536802,2019,0,0,0,0,0,0
3536901,2019,0,0,0,0,0,0
3537008,2019,64,"3,9",55,"3,4",9,"0,6"
3537107,2019,98,"2,1",98,"2,1",0,0
3537156,2019,0,0,0,0,0,0
3537206,2019,0,0,0,0,0,0
3537305,2019,200,"3,3",173,"2,9",27,"0,4"
3537404,2019,52,"2,1",47,"1,9",5,"0,2"
3537503,2019,0,0,0,0,0,0
3537602,2019,14,"0,2",14,"0,2",0,0
3537701,2019,0,0,0,0,0,0
3537800,2019,60,"1,1",50,"0,9",10,"0,2"
3537909,2019,35,"1,2",27,1,8,"0,3"
3538006,2019,254,"1,6",127,"0,8",127,"0,8"
3538105,2019,0,0,0,0,0,0
3538204,2019,0,0,0,0,0,0
3538303,2019,0,0,0,0,0,0
3538501,2019,0,0,0,0,0,0
3538600,2019,37,"1,4",29,"1,1",8,"0,3"
3538709,2019,711,"1,8",331,"0,9",380,1
3538808,2019,77,"2,7",58,2,19,"0,7"
3538907,2019,288,"12,4",67,"2,9",221,"9,5"
3539004,2019,41,"3,8",9,"0,8",32,3
3539103,2019,0,0,0,0,0,0
3539202,2019,0,0,0,0,0,0
3539301,2019,151,"2,1",57,"0,8",94,"1,3"
3539400,2019,28,"2,1",25,"1,9",3,"0,2"
3539509,2019,50,"1,3",32,"0,8",18,"0,5"
3539608,2019,0,0,0,0,0,0
3539707,2019,0,0,0,0,0,0
3539806,2019,36,"0,3",36,"0,3",0,0
3539905,2019,0,0,0,0,0,0
3540002,2019,19,"0,9",14,"0,7",5,"0,2"
3540101,2019,0,0,0,0,0,0
3540200,2019,45,"0,9",29,"0,6",16,"0,3"
3540259,2019,0,0,0,0,0,0
3540309,2019,0,0,0,0,0,0
3540408,2019,18,"4,5",7,"1,7",11,"2,7"
3540507,2019,0,0,0,0,0,0
3540606,2019,51,1,39,"0,8",12,"0,2"
3540705,2019,55,1,33,"0,6",22,"0,4"
3540754,2019,0,0,0,0,0,0
3540804,2019,31,"1,9",27,"1,6",4,"0,2"
3540853,2019,0,0,0,0,0,0
3540903,2019,0,0,0,0,0,0
3541000,2019,212,"0,7",199,"0,6",13,0
3541059,2019,0,0,0,0,0,0
3541109,2019,0,0,0,0,0,0
3541208,2019,51,"3,7",40,"2,9",11,"0,8"
3541307,2019,78,"1,8",68,"1,6",10,"0,2"
3541406,2019,1165,"5,3",689,"3,1",476,"2,2"
3541505,2019,96,"2,5",60,"1,6",36,"0,9"
3541604,2019,37,"0,9",37,"0,9",0,0
3541653,2019,0,0,0,0,0,0
3541703,2019,0,0,0,0,0,0
3541802,2019,0,0,0,0,0,0
3541901,2019,38,3,38,3,0,0
3542008,2019,0,0,0,0,0,0
3542107,2019,0,0,0,0,0,0
3542206,2019,103,"3,6",71,"2,5",32,"1,1"
3542305,2019,0,0,0,0,0,0
3542404,2019,16,"0,8",13,"0,7",3,"0,2"
3542503,2019,0,0,0,0,0,0
3542602,2019,181,"3,3",128,"2,4",53,1
3542701,2019,0,0,0,0,0,0
3542800,2019,0,0,0,0,0,0
3542909,2019,17,"1,3",11,"0,9",6,"0,5"
3543006,2019,36,2,35,2,1,"0,1"
3543105,2019,0,0,0,0,0,0
3543204,2019,0,0,0,0,0,0
3543238,2019,0,0,0,0,0,0
3543253,2019,0,0,0,0,0,0
3543303,2019,164,"1,4",50,"0,4",114,1
3543402,2019,2183,"3,2",1388,"2,1",795,"1,2"
3543501,2019,0,0,0,0,0,0
3543600,2019,0,0,0,0,0,0
3543709,2019,0,0,0,0,0,0
3543808,2019,23,"2,4",20,"2,1",3,"0,3"
3543907,2019,391,2,188,"0,9",203,1
3544004,2019,36,"1,1",32,"0,9",4,"0,1"
3544103,2019,0,0,0,0,0,0
3544202,2019,36,"3,2",7,"0,6",29,"2,6"
3544251,2019,57,"3,1",57,"3,1",0,0
3544301,2019,54,"5,1",14,"1,3",40,"3,8"
3544400,2019,0,0,0,0,0,0
3544509,2019,0,0,0,0,0,0
3544608,2019,0,0,0,0,0,0
3544707,2019,0,0,0,0,0,0
3544806,2019,0,0,0,0,0,0
3544905,2019,30,"2,6",20,"1,7",10,"0,9"
3545001,2019,19,"1,1",17,1,2,"0,1"
3545100,2019,0,0,0,0,0,0
3545159,2019,0,0,0,0,0,0
3545209,2019,130,"1,1",82,"0,7",48,"0,4"
3545308,2019,48,"1,1",43,1,5,"0,1"
3545407,2019,34,"3,8",22,"2,4",12,"1,3"
3545506,2019,0,0,0,0,0,0
3545605,2019,24,"1,6",7,"0,5",17,"1,1"
3545704,2019,0,0,0,0,0,0
3545803,2019,160,"0,9",97,"0,5",63,"0,3"
3546009,2019,0,0,0,0,0,0
3546108,2019,0,0,0,0,0,0
3546207,2019,0,0,0,0,0,0
3546256,2019,0,0,0,0,0,0
3546306,2019,35,1,25,"0,7",10,"0,3"
3546405,2019,96,"2,1",55,"1,2",41,"0,9"
3546504,2019,0,0,0,0,0,0
3546603,2019,82,"2,7",57,"1,9",25,"0,8"
3546702,2019,0,0,0,0,0,0
3546801,2019,101,"1,8",82,"1,5",19,"0,3"
3546900,2019,0,0,0,0,0,0
3547007,2019,6,1,6,1,0,0
3547106,2019,0,0,0,0,0,0
3547205,2019,0,0,0,0,0,0
3547304,2019,30,"0,2",30,"0,2",0,0
3547403,2019,0,0,0,0,0,0
3547502,2019,316,12,293,"11,1",23,"0,9"
3547601,2019,32,"1,3",21,"0,8",11,"0,4"
3547650,2019,0,0,0,0,0,0
3547700,2019,56,"2,8",37,"1,8",19,"0,9"
3547809,2019,1540,"2,2",708,1,832,"1,2"
3547908,2019,19,"2,9",19,"2,9",0,0
3548005,2019,0,0,0,0,0,0
3548054,2019,0,0,0,0,0,0
3548104,2019,0,0,0,0,0,0
3548203,2019,0,0,0,0,0,0
3548302,2019,0,0,0,0,0,0
3548401,2019,0,0,0,0,0,0
3548500,2019,1716,4,858,2,858,2
3548609,2019,40,"3,8",26,"2,5",14,"1,3"
3548708,2019,1583,2,588,"0,7",995,"1,2"
3548807,2019,618,"4,1",177,"1,2",441,"2,9"
3548906,2019,436,"1,8",211,"0,9",225,"0,9"
3549003,2019,0,0,0,0,0,0
3549102,2019,199,"2,3",94,"1,1",105,"1,2"
3549201,2019,0,0,0,0,0,0
3549250,2019,0,0,0,0,0,0
3549300,2019,0,0,0,0,0,0
3549409,2019,115,"2,3",68,"1,4",47,"0,9"
3549508,2019,0,0,0,0,0,0
3549607,2019,0,0,0,0,0,0
3549706,2019,136,"2,6",81,"1,5",55,1
3549805,2019,1905,"4,3",886,2,1019,"2,3"
3549904,2019,1672,"2,4",824,"1,2",848,"1,2"
3549953,2019,0,0,0,0,0,0
3550001,2019,25,"2,4",16,"1,5",9,"0,9"
3550100,2019,35,"0,9",31,"0,8",4,"0,1"
3550209,2019,50,"1,6",50,"1,6",0,0
3550308,2019,28494,"2,4",14530,"1,2",13964,"1,2"
3550407,2019,62,"1,8",40,"1,2",22,"0,6"
3550506,2019,0,0,0,0,0,0
3550605,2019,97,"1,1",46,"0,5",51,"0,6"
3550704,2019,101,"1,2",93,"1,1",8,"0,1"
3550803,2019,30,"2,5",26,"2,2",4,"0,3"
3550902,2019,40,"2,7",32,"2,2",8,"0,5"
3551009,2019,269,"0,8",158,"0,4",111,"0,3"
3551108,2019,0,0,0,0,0,0
3551207,2019,0,0,0,0,0,0
3551306,2019,0,0,0,0,0,0
3551405,2019,0,0,0,0,0,0
3551504,2019,125,"2,8",112,"2,6",13,"0,3"
3551603,2019,49,"1,8",33,"1,2",16,"0,6"
3551702,2019,162,"1,3",66,"0,5",96,"0,8"
3551801,2019,0,0,0,0,0,0
3551900,2019,0,0,0,0,0,0
3552007,2019,2,"0,3",2,"0,3",0,0
3552106,2019,70,"1,8",63,"1,6",7,"0,2"
3552205,2019,1429,"2,2",853,"1,3",576,"0,9"
3552304,2019,22,"2,9",20,"2,6",2,"0,3"
3552403,2019,177,"0,6",172,"0,6",5,0
3552502,2019,139,"0,5",61,"0,2",78,"0,3"
3552551,2019,0,0,0,0,0,0
3552601,2019,30,"2,5",11,"0,9",19,"1,6"
3552700,2019,35,"2,2",22,"1,4",13,"0,8"
3552809,2019,482,"1,7",321,"1,1",161,"0,6"
3552908,2019,0,0,0,0,0,0
3553005,2019,29,"2,2",24,"1,8",5,"0,4"
3553104,2019,0,0,0,0,0,0
3553203,2019,4,"0,6",4,"0,6",0,0
3553302,2019,36,"1,6",25,"1,1",11,"0,5"
3553401,2019,72,"2,9",30,"1,2",42,"1,7"
3553500,2019,0,0,0,0,0,0
3553609,2019,16,"1,3",13,1,3,"0,2"
3553658,2019,0,0,0,0,0,0
3553708,2019,124,"2,3",72,"1,3",52,1
3553807,2019,49,"2,1",31,"1,3",18,"0,8"
3553856,2019,0,0,0,0,0,0
3553906,2019,0,0,0,0,0,0
3553955,2019,0,0,0,0,0,0
3554003,2019,129,"1,1",78,"0,7",51,"0,4"
3554102,2019,509,"1,7",330,"1,1",179,"0,6"
3554201,2019,0,0,0,0,0,0
3554300,2019,58,"2,6",52,"2,3",6,"0,3"
3554409,2019,34,"3,8",30,"3,3",4,"0,4"
3554508,2019,55,"1,4",33,"0,8",22,"0,5"
3554607,2019,0,0,0,0,0,0
3554656,2019,0,0,0,0,0,0
3554706,2019,20,"2,1",13,"1,3",7,"0,7"
3554755,2019,0,0,0,0,0,0
3554805,2019,0,0,0,0,0,0
3554904,2019,0,0,0,0,0,0
3554953,2019,0,0,0,0,0,0
3555000,2019,446,"7,1",330,"5,2",116,"1,8"
3555109,2019,48,"3,2",30,2,18,"1,2"
3555208,2019,0,0,0,0,0,0
3555307,2019,0,0,0,0,0,0
3555356,2019,0,0,0,0,0,0
3555406,2019,92,1,74,"0,8",18,"0,2"
3555505,2019,0,0,0,0,0,0
3555604,2019,0,0,0,0,0,0
3555703,2019,0,0,0,0,0,0
3555802,2019,26,3,24,"2,8",2,"0,2"
3555901,2019,0,0,0,0,0,0
3556008,2019,34,"2,6",11,"0,8",23,"1,8"
3556107,2019,0,0,0,0,0,0
3556206,2019,142,"1,2",57,"0,5",85,"0,7"
3556305,2019,55,"2,3",31,"1,3",24,1
3556354,2019,0,0,0,0,0,0
3556404,2019,50,"1,2",31,"0,8",19,"0,5"
3556453,2019,70,"1,4",2,0,68,"1,3"
3556503,2019,39,"0,3",31,"0,3",8,"0,1"
3556602,2019,72,"6,8",0,0,72,"6,8"
3556701,2019,85,"1,1",62,"0,8",23,"0,3"
3556800,2019,48,"2,6",30,"1,6",18,1
3556909,2019,0,0,0,0,0,0
3556958,2019,0,0,0,0,0,0
3557006,2019,212,"1,8",53,"0,4",159,"1,3"
3557105,2019,205,"2,3",115,"1,3",90,1
3557154,2019,0,0,0,0,0,0
3557204,2019,50,"4,1",30,"2,5",20,"1,6"
3557303,2019,0,0,0,0,0,0
3500105,2020,235,"6,9",206,"6,1",29,"0,9"
3500204,2020,0,0,0,0,0,0
3500303,2020,0,0,0,0,0,0
3500402,2020,0,0,0,0,0,0
3500501,2020,30,"1,6",22,"1,2",8,"0,4"
3500550,2020,0,0,0,0,0,0
3500600,2020,0,0,0,0,0,0
3500709,2020,55,"1,5",39,"1,1",16,"0,4"
3500758,2020,0,0,0,0,0,0
3500808,2020,0,0,0,0,0,0
3500907,2020,0,0,0,0,0,0
3501004,2020,31,2,25,"1,6",6,"0,4"
3501103,2020,22,"5,5",19,"4,7",3,"0,7"
3501152,2020,0,0,0,0,0,0
3501202,2020,0,0,0,0,0,0
3501301,2020,20,"0,8",18,"0,8",2,"0,1"
3501400,2020,0,0,0,0,0,0
3501509,2020,0,0,0,0,0,0
3501608,2020,508,"2,2",196,"0,8",312,"1,3"
3501707,2020,193,"4,8",193,"4,8",0,0
3501806,2020,0,0,0,0,0,0
3501905,2020,392,"5,6",215,"3,1",177,"2,5"
3502002,2020,0,0,0,0,0,0
3502101,2020,102,"1,8",69,"1,2",33,"0,6"
3502200,2020,57,"2,3",54,"2,2",3,"0,1"
3502309,2020,0,0,0,0,0,0
3502408,2020,0,0,0,0,0,0
3502507,2020,106,3,73,2,33,"0,9"
3502606,2020,14,"3,4",13,"3,1",1,"0,2"
3502705,2020,56,"2,3",51,"2,1",5,"0,2"
3502754,2020,0,0,0,0,0,0
3502804,2020,412,"2,2",248,"1,3",164,"0,9"
3502903,2020,325,10,4,"0,1",321,"9,9"
3503000,2020,0,0,0,0,0,0
3503109,2020,12,"1,9",12,"1,9",0,0
3503158,2020,0,0,0,0,0,0
3503208,2020,454,2,254,"1,1",200,"0,9"
3503307,2020,499,"3,8",252,"1,9",247,"1,9"
3503356,2020,0,0,0,0,0,0
3503406,2020,29,"3,5",18,"2,2",11,"1,3"
3503505,2020,0,0,0,0,0,0
3503604,2020,0,0,0,0,0,0
3503703,2020,0,0,0,0,0,0
3503802,2020,36,"0,7",0,0,36,"0,7"
3503901,2020,98,"1,1",30,"0,3",68,"0,8"
3503950,2020,0,0,0,0,0,0
3504008,2020,278,"2,7",153,"1,5",125,"1,2"
3504107,2020,192,"1,4",55,"0,4",137,1
3504206,2020,40,"2,8",35,"2,4",5,"0,3"
3504305,2020,0,0,0,0,0,0
3504404,2020,0,0,0,0,0,0
3504503,2020,159,"1,8",95,"1,1",64,"0,7"
3504602,2020,0,0,0,0,0,0
3504701,2020,0,0,0,0,0,0
3504800,2020,0,0,0,0,0,0
3504909,2020,15,"1,4",15,"1,4",0,0
3505005,2020,0,0,0,0,0,0
3505104,2020,0,0,0,0,0,0
3505203,2020,51,"1,5",34,1,17,"0,5"
3505302,2020,91,"2,6",59,"1,7",32,"0,9"
3505351,2020,0,0,0,0,0,0
3505401,2020,0,0,0,0,0,0
3505500,2020,503,"4,3",391,"3,3",112,"0,9"
3505609,2020,0,0,0,0,0,0
3505708,2020,496,"1,9",420,"1,6",76,"0,3"
3505807,2020,35,"1,7",28,"1,4",7,"0,3"
3505906,2020,133,"2,2",101,"1,7",32,"0,5"
3506003,2020,1268,"3,5",676,"1,9",592,"1,6"
3506102,2020,153,"2,1",88,"1,2",65,"0,9"
3506201,2020,0,0,0,0,0,0
3506300,2020,23,"2,1",23,"2,1",0,0
3506359,2020,59,"0,9",59,"0,9",0,0
3506409,2020,36,"4,6",35,"4,5",1,"0,1"
3506508,2020,146,"1,2",66,"0,5",80,"0,7"
3506607,2020,0,0,0,0,0,0
3506706,2020,11,"0,8",10,"0,7",1,"0,1"
3506805,2020,35,"2,9",29,"2,4",6,"0,5"
3506904,2020,0,0,0,0,0,0
3507001,2020,48,"0,8",38,"0,7",10,"0,2"
3507100,2020,11,"0,5",11,"0,5",0,0
3507159,2020,0,0,0,0,0,0
3507209,2020,0,0,0,0,0,0
3507308,2020,0,0,0,0,0,0
3507407,2020,26,"1,7",16,1,10,"0,7"
3507456,2020,0,0,0,0,0,0
3507506,2020,714,"5,1",541,"3,8",173,"1,2"
3507605,2020,402,"2,5",221,"1,3",181,"1,1"
3507704,2020,0,0,0,0,0,0
3507753,2020,0,0,0,0,0,0
3507803,2020,0,0,0,0,0,0
3507902,2020,41,"1,7",35,"1,5",6,"0,3"
3508009,2020,0,0,0,0,0,0
3508108,2020,36,"2,2",18,"1,1",18,"1,1"
3508207,2020,0,0,0,0,0,0
3508306,2020,0,0,0,0,0,0
3508405,2020,16,"0,3",11,"0,2",5,"0,1"
3508504,2020,176,"1,9",60,"0,7",116,"1,3"
3508603,2020,21,"0,7",21,"0,7",0,0
3508702,2020,62,"3,3",62,"3,3",0,0
3508801,2020,48,"2,8",37,"2,1",11,"0,6"
3508900,2020,0,0,0,0,0,0
3509007,2020,129,"1,3",85,"0,8",44,"0,4"
3509106,2020,0,0,0,0,0,0
3509205,2020,125,"1,6",25,"0,3",100,"1,3"
3509254,2020,0,0,0,0,0,0
3509304,2020,32,"3,2",26,"2,6",6,"0,6"
3509403,2020,140,"5,5",55,"2,1",85,"3,3"
3509452,2020,0,0,0,0,0,0
3509502,2020,2696,"2,3",1357,"1,2",1339,"1,1"
3509601,2020,68,"0,8",68,"0,8",0,0
3509700,2020,201,4,191,"3,8",10,"0,2"
3509809,2020,0,0,0,0,0,0
3509908,2020,0,0,0,0,0,0
3509957,2020,0,0,0,0,0,0
3510005,2020,30,1,25,"0,8",5,"0,2"
3510104,2020,0,0,0,0,0,0
3510153,2020,0,0,0,0,0,0
3510203,2020,50,"1,1",43,"0,9",7,"0,2"
3510302,2020,59,"2,9",14,"0,7",45,"2,2"
3510401,2020,108,2,59,"1,1",49,"0,9"
3510500,2020,257,"2,2",203,"1,7",54,"0,5"
3510609,2020,270,"0,7",220,"0,6",50,"0,1"
3510708,2020,31,"2,6",12,1,19,"1,6"
3510807,2020,372,"12,6",356,"12,1",16,"0,5"
3510906,2020,0,0,0,0,0,0
3511003,2020,31,"1,5",30,"1,4",1,0
3511102,2020,600,"5,1",374,"3,2",226,"1,9"
3511201,2020,0,0,0,0,0,0
3511300,2020,50,"5,7",0,0,50,"5,7"
3511409,2020,39,2,32,"1,7",7,"0,4"
3511508,2020,48,1,38,"0,8",10,"0,2"
3511607,2020,22,"1,3",17,1,5,"0,3"
3511706,2020,33,"1,9",26,"1,5",7,"0,4"
3511904,2020,24,"2,9",21,"2,5",3,"0,4"
3512001,2020,47,"2,7",35,2,12,"0,7"
3512100,2020,20,"3,3",20,"3,3",0,0
3512209,2020,52,"1,9",42,"1,5",10,"0,4"
3512308,2020,12,"0,7",12,"0,7",0,0
3512407,2020,0,0,0,0,0,0
3512506,2020,0,0,0,0,0,0
3512605,2020,6,"1,2",6,"1,2",0,0
3512704,2020,0,0,0,0,0,0
3512803,2020,71,1,31,"0,4",40,"0,6"
3512902,2020,0,0,0,0,0,0
3513009,2020,519,"2,1",159,"0,6",360,"1,5"
3513108,2020,15,"0,4",13,"0,4",2,"0,1"
3513207,2020,0,0,0,0,0,0
3513306,2020,0,0,0,0,0,0
3513405,2020,143,"1,8",112,"1,4",31,"0,4"
3513504,2020,133,1,106,"0,8",27,"0,2"
3513603,2020,40,"1,8",25,"1,2",15,"0,7"
3513702,2020,68,"2,1",48,"1,5",20,"0,6"
3513801,2020,642,"1,6",573,"1,4",69,"0,2"
3513850,2020,0,0,0,0,0,0
3513900,2020,194,"17,8",194,"17,8",0,0
3514007,2020,0,0,0,0,0,0
3514106,2020,67,"2,5",47,"1,7",20,"0,7"
3514205,2020,0,0,0,0,0,0
3514304,2020,10,"1,2",10,"1,2",0,0
3514403,2020,143,"3,2",108,"2,4",35,"0,8"
3514502,2020,87,"7,3",77,"6,4",10,"0,8"
3514601,2020,0,0,0,0,0,0
3514700,2020,0,0,0,0,0,0
3514809,2020,2,"0,1",2,"0,1",0,0
3514908,2020,6,"0,3",6,"0,3",0,0
3514924,2020,0,0,0,0,0,0
3514957,2020,0,0,0,0,0,0
3515004,2020,244,"0,9",89,"0,3",155,"0,6"
3515103,2020,17,"0,2",17,"0,2",0,0
3515129,2020,0,0,0,0,0,0
3515152,2020,0,0,0,0,0,0
3515186,2020,453,"10,6",354,"8,3",99,"2,3"
3515194,2020,0,0,0,0,0,0
3515202,2020,37,"4,6",31,"3,8",6,"0,7"
3515301,2020,0,0,0,0,0,0
3515350,2020,0,0,0,0,0,0
3515400,2020,20,"1,3",12,"0,8",8,"0,5"
3515509,2020,135,2,84,"1,3",51,"0,8"
3515608,2020,0,0,0,0,0,0
3515657,2020,0,0,0,0,0,0
3515707,2020,209,"1,1",209,"1,1",0,0
3515806,2020,0,0,0,0,0,0
3515905,2020,0,0,0,0,0,0
3516002,2020,47,"3,9",30,"2,5",17,"1,4"
3516101,2020,0,0,0,0,0,0
3516200,2020,729,"2,1",542,"1,6",187,"0,5"
3516309,2020,164,"0,9",164,"0,9",0,0
3516408,2020,661,"4,3",611,4,50,"0,3"
3516507,2020,0,0,0,0,0,0
3516606,2020,45,"6,9",27,"4,1",18,"2,7"
3516705,2020,280,"6,6",251,"5,9",29,"0,7"
3516804,2020,0,0,0,0,0,0
3516853,2020,0,0,0,0,0,0
3516903,2020,28,"2,6",19,"1,8",9,"0,8"
3517000,2020,38,"3,5",36,"3,3",2,"0,2"
3517109,2020,0,0,0,0,0,0
3517208,2020,0,0,0,0,0,0
3517307,2020,0,0,0,0,0,0
3517406,2020,61,"1,6",43,"1,1",18,"0,5"
3517505,2020,0,0,0,0,0,0
3517604,2020,27,"1,5",27,"1,5",0,0
3517703,2020,48,"2,3",40,"1,9",8,"0,4"
3517802,2020,23,"2,7",15,"1,8",8,1
3517901,2020,0,0,0,0,0,0
3518008,2020,0,0,0,0,0,0
3518107,2020,0,0,0,0,0,0
3518206,2020,74,"2,3",48,"1,5",26,"0,8"
3518305,2020,35,"1,2",29,1,6,"0,2"
3518404,2020,269,"2,3",122,1,147,"1,2"
3518503,2020,0,0,0,0,0,0
3518602,2020,71,"1,8",64,"1,6",7,"0,2"
3518701,2020,435,"1,4",332,1,103,"0,3"
3518800,2020,1995,"1,5",1496,"1,1",499,"0,4"
3518859,2020,0,0,0,0,0,0
3518909,2020,0,0,0,0,0,0
3519006,2020,58,"6,3",58,"6,3",0,0
3519055,2020,0,0,0,0,0,0
3519071,2020,100,"0,4",78,"0,3",22,"0,1"
3519105,2020,30,"2,7",28,"2,5",2,"0,2"
3519204,2020,0,0,0,0,0,0
3519253,2020,0,0,0,0,0,0
3519303,2020,27,"0,8",27,"0,8",0,0
3519402,2020,27,"2,2",9,"0,7",18,"1,5"
3519501,2020,0,0,0,0,0,0
3519600,2020,103,"1,8",46,"0,8",57,1
3519709,2020,201,"2,6",57,"0,7",144,"1,9"
3519808,2020,0,0,0,0,0,0
3519907,2020,18,"2,3",18,"2,3",0,0
3520004,2020,0,0,0,0,0,0
3520103,2020,47,"1,6",37,"1,3",10,"0,3"
3520202,2020,8,"0,9",8,"0,9",0,0
3520301,2020,9,"0,3",9,"0,3",0,0
3520400,2020,59,"1,8",59,"1,8",0,0
3520426,2020,0,0,0,0,0,0
3520442,2020,110,"4,3",74,"2,9",36,"1,4"
3520509,2020,350,"1,4",207,"0,9",143,"0,6"
3520608,2020,0,0,0,0,0,0
3520707,2020,36,"9,3",4,1,32,"8,3"
3520806,2020,0,0,0,0,0,0
3520905,2020,49,"3,4",29,2,20,"1,4"
3521002,2020,15,"0,4",15,"0,4",0,0
3521101,2020,0,0,0,0,0,0
3521150,2020,0,0,0,0,0,0
3521200,2020,0,0,0,0,0,0
3521309,2020,39,"2,5",29,"1,8",10,"0,6"
3521408,2020,3,"0,1",3,"0,1",0,0
3521507,2020,0,0,0,0,0,0
3521606,2020,0,0,0,0,0,0
3521705,2020,19,"1,1",19,"1,1",0,0
3521804,2020,35,"1,3",35,"1,3",0,0
3521903,2020,50,"3,4",32,"2,2",18,"1,2"
3522000,2020,0,0,0,0,0,0
3522109,2020,141,"1,4",141,"1,4",0,0
3522158,2020,0,0,0,0,0,0
3522208,2020,589,"3,5",182,"1,1",407,"2,4"
3522307,2020,152,"0,9",110,"0,7",42,"0,3"
3522406,2020,134,"1,5",93,1,41,"0,4"
3522505,2020,334,"1,4",245,1,89,"0,4"
3522604,2020,1093,"15,3",592,"8,3",501,7
3522653,2020,0,0,0,0,0,0
3522703,2020,65,"1,6",35,"0,8",30,"0,7"
3522802,2020,46,"3,1",27,"1,8",19,"1,3"
3522901,2020,30,"2,2",30,"2,2",0,0
3523008,2020,0,0,0,0,0,0
3523107,2020,247,"0,7",247,"0,7",0,0
3523206,2020,61,"1,2",51,1,10,"0,2"
3523305,2020,0,0,0,0,0,0
3523404,2020,120,1,70,"0,6",50,"0,4"
3523503,2020,14,"0,7",7,"0,3",7,"0,3"
3523602,2020,22,"1,3",22,"1,3",0,0
3523701,2020,0,0,0,0,0,0
3523800,2020,0,0,0,0,0,0
3523909,2020,328,"1,9",328,"1,9",0,0
3524006,2020,74,"1,3",36,"0,6",38,"0,6"
3524105,2020,120,3,53,"1,3",67,"1,7"
3524204,2020,17,"2,5",17,"2,5",0,0
3524303,2020,212,"2,9",56,"0,8",156,"2,1"
3524402,2020,377,"1,7",181,"0,8",196,"0,9"
3524501,2020,216,31,149,"21,4",67,"9,6"
3524600,2020,0,0,0,0,0,0
3524709,2020,94,"1,7",92,"1,7",2,0
3524808,2020,151,"3,2",103,"2,2",48,1
3524907,2020,0,0,0,0,0,0
3525003,2020,25,"0,2",10,"0,1",15,"0,1"
3525102,2020,0,0,0,0,0,0
3525201,2020,29,1,17,"0,6",12,"0,4"
3525300,2020,895,"6,1",671,"4,5",224,"1,5"
3525409,2020,0,0,0,0,0,0
3525508,2020,11,"0,9",11,"0,9",0,0
3525607,2020,0,0,0,0,0,0
3525706,2020,53,"1,5",22,"0,6",31,"0,9"
3525805,2020,0,0,0,0,0,0
3525854,2020,0,0,0,0,0,0
3525904,2020,813,2,429,"1,1",384,"0,9"
3526001,2020,52,"2,6",25,"1,2",27,"1,3"
3526100,2020,0,0,0,0,0,0
3526209,2020,8,"0,3",0,0,8,"0,3"
3526308,2020,0,0,0,0,0,0
3526407,2020,46,"1,7",28,1,18,"0,6"
3526506,2020,0,0,0,0,0,0
3526605,2020,0,0,0,0,0,0
3526704,2020,122,"1,2",77,"0,8",45,"0,4"
3526803,2020,88,"1,3",45,"0,7",43,"0,6"
3526902,2020,384,"1,3",208,"0,7",176,"0,6"
3527009,2020,0,0,0,0,0,0
3527108,2020,444,"5,9",336,"4,5",108,"1,4"
3527207,2020,170,2,85,1,85,1
3527256,2020,0,0,0,0,0,0
3527306,2020,36,"0,7",30,"0,6",6,"0,1"
3527405,2020,32,"1,5",26,"1,2",6,"0,3"
3527504,2020,0,0,0,0,0,0
3527603,2020,0,0,0,0,0,0
3527702,2020,3,"0,5",3,"0,5",0,0
3527801,2020,0,0,0,0,0,0
3527900,2020,0,0,0,0,0,0
3528007,2020,31,"1,8",18,"1,1",13,"0,8"
3528106,2020,18,"2,3",15,"1,9",3,"0,4"
3528205,2020,0,0,0,0,0,0
3528304,2020,0,0,0,0,0,0
3528403,2020,0,0,0,0,0,0
3528502,2020,77,"0,8",71,"0,7",6,"0,1"
3528601,2020,0,0,0,0,0,0
3528700,2020,0,0,0,0,0,0
3528809,2020,26,"1,9",22,"1,6",4,"0,3"
3528858,2020,0,0,0,0,0,0
3528908,2020,0,0,0,0,0,0
3529005,2020,867,"3,7",660,"2,9",207,"0,9"
3529104,2020,0,0,0,0,0,0
3529203,2020,45,"1,8",40,"1,6",5,"0,2"
3529302,2020,182,"2,3",116,"1,4",66,"0,8"
3529401,2020,432,"0,9",219,"0,5",213,"0,5"
3529500,2020,0,0,0,0,0,0
3529609,2020,0,0,0,0,0,0
3529658,2020,0,0,0,0,0,0
3529708,2020,89,"4,2",68,"3,2",21,1
3529807,2020,11,"0,9",11,"0,9",0,0
3529906,2020,0,0,0,0,0,0
3530003,2020,0,0,0,0,0,0
3530102,2020,68,"2,4",68,"2,4",0,0
3530201,2020,0,0,0,0,0,0
3530300,2020,81,"1,4",30,"0,5",51,"0,9"
3530409,2020,0,0,0,0,0,0
3530508,2020,125,"1,9",78,"1,2",47,"0,7"
3530607,2020,926,"2,1",630,"1,5",296,"0,7"
3530706,2020,372,"2,5",180,"1,2",192,"1,3"
3530805,2020,196,"2,2",131,"1,4",65,"0,7"
3530904,2020,0,0,0,0,0,0
3531001,2020,0,0,0,0,0,0
3531100,2020,36,"0,7",36,"0,7",0,0
3531209,2020,0,0,0,0,0,0
3531308,2020,109,"2,3",58,"1,2",51,"1,1"
3531407,2020,80,"3,4",30,"1,3",50,"2,1"
3531506,2020,70,"3,8",51,"2,8",19,1
3531605,2020,0,0,0,0,0,0
3531704,2020,0,0,0,0,0,0
3531803,2020,35,"0,6",26,"0,4",9,"0,2"
3531902,2020,32,1,23,"0,7",9,"0,3"
3532009,2020,19,"1,4",9,"0,7",10,"0,8"
3532058,2020,0,0,0,0,0,0
3532108,2020,0,0,0,0,0,0
3532157,2020,0,0,0,0,0,0
3532207,2020,0,0,0,0,0,0
3532306,2020,0,0,0,0,0,0
3532405,2020,20,"1,1",20,"1,1",0,0
3532504,2020,21,"2,4",10,"1,2",11,"1,3"
3532603,2020,129,12,35,"3,2",94,"8,7"
3532702,2020,0,0,0,0,0,0
3532801,2020,0,0,0,0,0,0
3532827,2020,0,0,0,0,0,0
3532843,2020,0,0,0,0,0,0
3532868,2020,0,0,0,0,0,0
3532900,2020,18,"1,7",13,"1,2",5,"0,5"
3533007,2020,62,3,19,"0,9",43,"2,1"
3533106,2020,0,0,0,0,0,0
3533205,2020,0,0,0,0,0,0
3533254,2020,0,0,0,0,0,0
3533304,2020,0,0,0,0,0,0
3533403,2020,67,"1,2",67,"1,2",0,0
3533502,2020,105,"2,7",35,"0,9",70,"1,8"
3533601,2020,0,0,0,0,0,0
3533700,2020,0,0,0,0,0,0
3533809,2020,0,0,0,0,0,0
3533908,2020,79,"1,5",41,"0,8",38,"0,7"
3534005,2020,0,0,0,0,0,0
3534104,2020,0,0,0,0,0,0
3534203,2020,0,0,0,0,0,0
3534302,2020,118,"2,8",72,"1,7",46,"1,1"
3534401,2020,926,"1,4",626,"0,9",300,"0,4"
3534500,2020,0,0,0,0,0,0
3534609,2020,71,"2,3",47,"1,5",24,"0,8"
3534708,2020,204,"1,8",133,"1,2",71,"0,6"
3534757,2020,33,"3,4",28,"2,9",5,"0,5"
3534807,2020,0,0,0,0,0,0
3534906,2020,37,"2,8",32,"2,5",5,"0,4"
3535002,2020,0,0,0,0,0,0
3535101,2020,0,0,0,0,0,0
3535200,2020,20,"2,2",10,"1,1",10,"1,1"
3535309,2020,41,"1,9",27,"1,3",14,"0,6"
3535408,2020,31,2,31,2,0,0
3535507,2020,97,"2,2",78,"1,8",19,"0,4"
3535606,2020,0,0,0,0,0,0
3535705,2020,0,0,0,0,0,0
3535804,2020,13,"0,7",13,"0,7",0,0
3535903,2020,0,0,0,0,0,0
3536000,2020,32,3,26,"2,5",6,"0,6"
3536109,2020,0,0,0,0,0,0
3536208,2020,166,"8,6",166,"8,6",0,0
3536257,2020,0,0,0,0,0,0
3536307,2020,35,"2,4",23,"1,6",12,"0,8"
3536406,2020,0,0,0,0,0,0
3536505,2020,97,"0,9",97,"0,9",0,0
3536570,2020,0,0,0,0,0,0
3536604,2020,24,"2,8",18,"2,1",6,"0,7"
3536703,2020,42,"0,9",36,"0,8",6,"0,1"
3536802,2020,0,0,0,0,0,0
3536901,2020,0,0,0,0,0,0
3537008,2020,64,"3,9",55,"3,4",9,"0,6"
3537107,2020,98,"2,1",98,"2,1",0,0
3537156,2020,0,0,0,0,0,0
3537206,2020,0,0,0,0,0,0
3537305,2020,171,"2,8",161,"2,6",10,"0,2"
3537404,2020,52,2,47,"1,9",5,"0,2"
3537503,2020,0,0,0,0,0,0
3537602,2020,18,"0,3",18,"0,3",0,0
3537701,2020,0,0,0,0,0,0
3537800,2020,79,"1,5",59,"1,1",20,"0,4"
3537909,2020,35,"1,2",27,1,8,"0,3"
3538006,2020,274,"1,7",147,"0,9",127,"0,8"
3538105,2020,0,0,0,0,0,0
3538204,2020,0,0,0,0,0,0
3538303,2020,0,0,0,0,0,0
3538501,2020,0,0,0,0,0,0
3538600,2020,0,0,0,0,0,0
3538709,2020,680,"1,7",322,"0,8",358,"0,9"
3538808,2020,70,"2,4",51,"1,8",19,"0,7"
3538907,2020,285,"12,3",84,"3,6",201,"8,6"
3539004,2020,41,"3,8",9,"0,8",32,3
3539103,2020,0,0,0,0,0,0
3539202,2020,0,0,0,0,0,0
3539301,2020,173,"2,3",57,"0,8",116,"1,6"
3539400,2020,28,"2,1",25,"1,9",3,"0,2"
3539509,2020,50,"1,3",32,"0,8",18,"0,5"
3539608,2020,0,0,0,0,0,0
3539707,2020,0,0,0,0,0,0
3539806,2020,35,"0,3",35,"0,3",0,0
3539905,2020,0,0,0,0,0,0
3540002,2020,18,"0,8",13,"0,6",5,"0,2"
3540101,2020,0,0,0,0,0,0
3540200,2020,54,"1,1",38,"0,8",16,"0,3"
3540259,2020,0,0,0,0,0,0
3540309,2020,0,0,0,0,0,0
3540408,2020,18,"4,5",7,"1,8",11,"2,8"
3540507,2020,0,0,0,0,0,0
3540606,2020,60,"1,2",41,"0,8",19,"0,4"
3540705,2020,55,1,33,"0,6",22,"0,4"
3540754,2020,0,0,0,0,0,0
3540804,2020,31,"1,9",27,"1,6",4,"0,2"
3540853,2020,0,0,0,0,0,0
3540903,2020,0,0,0,0,0,0
3541000,2020,427,"1,3",294,"0,9",133,"0,4"
3541059,2020,0,0,0,0,0,0
3541109,2020,0,0,0,0,0,0
3541208,2020,51,"3,7",40,"2,9",11,"0,8"
3541307,2020,78,"1,8",68,"1,6",10,"0,2"
3541406,2020,1117,"5,1",683,"3,1",434,2
3541505,2020,96,"2,5",60,"1,6",36,"0,9"
3541604,2020,37,"0,9",37,"0,9",0,0
3541653,2020,0,0,0,0,0,0
3541703,2020,0,0,0,0,0,0
3541802,2020,0,0,0,0,0,0
3541901,2020,19,"1,5",19,"1,5",0,0
3542008,2020,0,0,0,0,0,0
3542107,2020,0,0,0,0,0,0
3542206,2020,103,"3,6",71,"2,5",32,"1,1"
3542305,2020,0,0,0,0,0,0
3542404,2020,35,"1,8",26,"1,3",9,"0,5"
3542503,2020,0,0,0,0,0,0
3542602,2020,197,"3,6",159,"2,9",38,"0,7"
3542701,2020,0,0,0,0,0,0
3542800,2020,0,0,0,0,0,0
3542909,2020,24,"1,9",18,"1,4",6,"0,5"
3543006,2020,34,"1,9",34,"1,9",0,0
3543105,2020,0,0,0,0,0,0
3543204,2020,0,0,0,0,0,0
3543238,2020,0,0,0,0,0,0
3543253,2020,0,0,0,0,0,0
3543303,2020,188,"1,6",74,"0,6",114,1
3543402,2020,2194,"3,2",1417,"2,1",777,"1,1"
3543501,2020,0,0,0,0,0,0
3543600,2020,0,0,0,0,0,0
3543709,2020,0,0,0,0,0,0
3543808,2020,23,"2,4",20,"2,1",3,"0,3"
3543907,2020,401,2,198,1,203,1
3544004,2020,36,1,32,"0,9",4,"0,1"
3544103,2020,0,0,0,0,0,0
3544202,2020,36,"3,1",7,"0,6",29,"2,5"
3544251,2020,80,"4,4",80,"4,4",0,0
3544301,2020,54,"5,1",14,"1,3",40,"3,8"
3544400,2020,0,0,0,0,0,0
3544509,2020,0,0,0,0,0,0
3544608,2020,0,0,0,0,0,0
3544707,2020,0,0,0,0,0,0
3544806,2020,0,0,0,0,0,0
3544905,2020,30,"2,6",20,"1,7",10,"0,9"
3545001,2020,19,"1,1",17,1,2,"0,1"
3545100,2020,0,0,0,0,0,0
3545159,2020,0,0,0,0,0,0
3545209,2020,145,"1,3",101,"0,9",44,"0,4"
3545308,2020,53,"1,2",48,"1,1",5,"0,1"
3545407,2020,34,"3,7",22,"2,4",12,"1,3"
3545506,2020,0,0,0,0,0,0
3545605,2020,24,"1,6",7,"0,5",17,"1,1"
3545704,2020,0,0,0,0,0,0
3545803,2020,165,"0,9",122,"0,6",43,"0,2"
3546009,2020,0,0,0,0,0,0
3546108,2020,0,0,0,0,0,0
3546207,2020,0,0,0,0,0,0
3546256,2020,0,0,0,0,0,0
3546306,2020,35,1,25,"0,7",10,"0,3"
3546405,2020,96,"2,1",55,"1,2",41,"0,9"
3546504,2020,0,0,0,0,0,0
3546603,2020,80,"2,6",67,"2,2",13,"0,4"
3546702,2020,0,0,0,0,0,0
3546801,2020,101,"1,8",82,"1,5",19,"0,3"
3546900,2020,8,"0,9",0,0,8,"0,9"
3547007,2020,6,1,6,1,0,0
3547106,2020,0,0,0,0,0,0
3547205,2020,0,0,0,0,0,0
3547304,2020,41,"0,3",41,"0,3",0,0
3547403,2020,0,0,0,0,0,0
3547502,2020,314,"11,9",291,11,23,"0,9"
3547601,2020,32,"1,2",19,"0,7",13,"0,5"
3547650,2020,0,0,0,0,0,0
3547700,2020,56,"2,8",37,"1,8",19,"0,9"
3547809,2020,1903,"2,7",1068,"1,5",835,"1,2"
3547908,2020,19,"2,9",19,"2,9",0,0
3548005,2020,0,0,0,0,0,0
3548054,2020,0,0,0,0,0,0
3548104,2020,0,0,0,0,0,0
3548203,2020,0,0,0,0,0,0
3548302,2020,0,0,0,0,0,0
3548401,2020,0,0,0,0,0,0
3548500,2020,1854,"4,3",975,"2,3",879,"2,1"
3548609,2020,40,"3,8",26,"2,5",14,"1,3"
3548708,2020,1926,"2,4",839,1,1087,"1,3"
3548807,2020,741,"4,9",177,"1,2",564,"3,7"
3548906,2020,487,2,262,"1,1",225,"0,9"
3549003,2020,0,0,0,0,0,0
3549102,2020,199,"2,3",94,"1,1",105,"1,2"
3549201,2020,0,0,0,0,0,0
3549250,2020,0,0,0,0,0,0
3549300,2020,0,0,0,0,0,0
3549409,2020,115,"2,3",68,"1,4",47,"0,9"
3549508,2020,0,0,0,0,0,0
3549607,2020,0,0,0,0,0,0
3549706,2020,127,"2,4",76,"1,4",51,1
3549805,2020,2099,"4,7",921,"2,1",1178,"2,6"
3549904,2020,1595,"2,2",728,1,867,"1,2"
3549953,2020,0,0,0,0,0,0
3550001,2020,25,"2,4",16,"1,5",9,"0,9"
3550100,2020,26,"0,7",23,"0,6",3,"0,1"
3550209,2020,48,"1,5",48,"1,5",0,0
3550308,2020,29025,"2,4",15431,"1,3",13594,"1,1"
3550407,2020,62,"1,8",50,"1,5",12,"0,4"
3550506,2020,0,0,0,0,0,0
3550605,2020,127,"1,5",73,"0,8",54,"0,6"
3550704,2020,137,"1,6",129,"1,5",8,"0,1"
3550803,2020,30,"2,5",26,"2,2",4,"0,3"
3550902,2020,40,"2,7",32,"2,2",8,"0,5"
3551009,2020,248,"0,7",152,"0,4",96,"0,3"
3551108,2020,0,0,0,0,0,0
3551207,2020,0,0,0,0,0,0
3551306,2020,0,0,0,0,0,0
3551405,2020,0,0,0,0,0,0
3551504,2020,125,"2,8",112,"2,5",13,"0,3"
3551603,2020,49,"1,8",33,"1,2",16,"0,6"
3551702,2020,136,"1,1",62,"0,5",74,"0,6"
3551801,2020,0,0,0,0,0,0
3551900,2020,0,0,0,0,0,0
3552007,2020,2,"0,3",2,"0,3",0,0
3552106,2020,70,"1,8",63,"1,6",7,"0,2"
3552205,2020,1424,"2,2",859,"1,3",565,"0,9"
3552304,2020,22,"2,9",20,"2,6",2,"0,3"
3552403,2020,197,"0,7",192,"0,7",5,0
3552502,2020,147,"0,5",69,"0,2",78,"0,3"
3552551,2020,0,0,0,0,0,0
3552601,2020,30,"2,5",11,"0,9",19,"1,6"
3552700,2020,35,"2,2",25,"1,6",10,"0,6"
3552809,2020,537,"1,9",376,"1,3",161,"0,6"
3552908,2020,0,0,0,0,0,0
3553005,2020,29,"2,2",24,"1,8",5,"0,4"
3553104,2020,0,0,0,0,0,0
3553203,2020,4,"0,6",4,"0,6",0,0
3553302,2020,42,"1,8",34,"1,5",8,"0,4"
3553401,2020,72,"2,9",30,"1,2",42,"1,7"
3553500,2020,0,0,0,0,0,0
3553609,2020,14,"1,1",12,1,2,"0,2"
3553658,2020,0,0,0,0,0,0
3553708,2020,124,"2,3",72,"1,3",52,1
3553807,2020,49,"2,1",31,"1,3",18,"0,8"
3553856,2020,0,0,0,0,0,0
3553906,2020,0,0,0,0,0,0
3553955,2020,0,0,0,0,0,0
3554003,2020,105,"0,9",59,"0,5",46,"0,4"
3554102,2020,553,"1,8",379,"1,2",174,"0,6"
3554201,2020,0,0,0,0,0,0
3554300,2020,58,"2,6",52,"2,3",6,"0,3"
3554409,2020,34,"3,7",30,"3,3",4,"0,4"
3554508,2020,55,"1,3",33,"0,8",22,"0,5"
3554607,2020,0,0,0,0,0,0
3554656,2020,0,0,0,0,0,0
3554706,2020,20,"2,1",13,"1,3",7,"0,7"
3554755,2020,0,0,0,0,0,0
3554805,2020,0,0,0,0,0,0
3554904,2020,0,0,0,0,0,0
3554953,2020,0,0,0,0,0,0
3555000,2020,346,"5,5",330,"5,3",16,"0,3"
3555109,2020,48,"3,2",30,2,18,"1,2"
3555208,2020,0,0,0,0,0,0
3555307,2020,0,0,0,0,0,0
3555356,2020,0,0,0,0,0,0
3555406,2020,130,"1,5",112,"1,3",18,"0,2"
3555505,2020,0,0,0,0,0,0
3555604,2020,0,0,0,0,0,0
3555703,2020,0,0,0,0,0,0
3555802,2020,26,3,24,"2,8",2,"0,2"
3555901,2020,0,0,0,0,0,0
3556008,2020,34,"2,6",11,"0,8",23,"1,7"
3556107,2020,0,0,0,0,0,0
3556206,2020,142,"1,1",57,"0,5",85,"0,7"
3556305,2020,55,"2,3",31,"1,3",24,1
3556354,2020,0,0,0,0,0,0
3556404,2020,58,"1,4",39,"0,9",19,"0,5"
3556453,2020,70,"1,3",2,0,68,"1,3"
3556503,2020,35,"0,3",31,"0,3",4,0
3556602,2020,72,"6,8",0,0,72,"6,8"
3556701,2020,85,"1,1",62,"0,8",23,"0,3"
3556800,2020,48,"2,6",30,"1,6",18,1
3556909,2020,0,0,0,0,0,0
3556958,2020,0,0,0,0,0,0
3557006,2020,237,2,78,"0,7",159,"1,3"
3557105,2020,205,"2,2",115,"1,3",90,1
3557154,2020,0,0,0,0,0,0
3557204,2020,50,"4,1",30,"2,5",20,"1,6"
3557303,2020,0,0,0,0,0,0
3500105,2021,235,"6,9",206,"6,1",29,"0,9"
3500204,2021,0,0,0,0,0,0
3500303,2021,0,0,0,0,0,0
3500402,2021,0,0,0,0,0,0
3500501,2021,30,"1,6",22,"1,2",8,"0,4"
3500550,2021,0,0,0,0,0,0
3500600,2021,0,0,0,0,0,0
3500709,2021,55,"1,5",39,"1,1",16,"0,4"
3500758,2021,0,0,0,0,0,0
3500808,2021,0,0,0,0,0,0
3500907,2021,0,0,0,0,0,0
3501004,2021,31,2,29,"1,9",2,"0,1"
3501103,2021,22,"5,5",19,"4,7",3,"0,7"
3501152,2021,120,"6,6",0,0,120,"6,6"
3501202,2021,0,0,0,0,0,0
3501301,2021,20,"0,8",18,"0,8",2,"0,1"
3501400,2021,0,0,0,0,0,0
3501509,2021,0,0,0,0,0,0
3501608,2021,485,"2,1",193,"0,8",292,"1,2"
3501707,2021,193,"4,7",193,"4,7",0,0
3501806,2021,0,0,0,0,0,0
3501905,2021,380,"5,4",220,"3,1",160,"2,3"
3502002,2021,0,0,0,0,0,0
3502101,2021,118,"2,1",83,"1,5",35,"0,6"
3502200,2021,57,"2,3",54,"2,2",3,"0,1"
3502309,2021,0,0,0,0,0,0
3502408,2021,0,0,0,0,0,0
3502507,2021,92,"2,6",69,"1,9",23,"0,6"
3502606,2021,14,"3,4",13,"3,2",1,"0,2"
3502705,2021,55,"2,2",51,"2,1",4,"0,2"
3502754,2021,0,0,0,0,0,0
3502804,2021,445,"2,3",281,"1,5",164,"0,9"
3502903,2021,329,10,8,"0,2",321,"9,8"
3503000,2021,0,0,0,0,0,0
3503109,2021,6,1,6,1,0,0
3503158,2021,0,0,0,0,0,0
3503208,2021,499,"2,2",299,"1,3",200,"0,9"
3503307,2021,499,"3,8",252,"1,9",247,"1,9"
3503356,2021,0,0,0,0,0,0
3503406,2021,32,"3,9",15,"1,8",17,"2,1"
3503505,2021,0,0,0,0,0,0
3503604,2021,0,0,0,0,0,0
3503703,2021,0,0,0,0,0,0
3503802,2021,63,"1,2",0,0,63,"1,2"
3503901,2021,97,"1,1",29,"0,3",68,"0,7"
3503950,2021,0,0,0,0,0,0
3504008,2021,302,3,169,"1,7",133,"1,3"
3504107,2021,192,"1,4",55,"0,4",137,1
3504206,2021,40,"2,8",35,"2,4",5,"0,3"
3504305,2021,0,0,0,0,0,0
3504404,2021,0,0,0,0,0,0
3504503,2021,159,"1,8",95,"1,1",64,"0,7"
3504602,2021,0,0,0,0,0,0
3504701,2021,0,0,0,0,0,0
3504800,2021,0,0,0,0,0,0
3504909,2021,15,"1,4",15,"1,4",0,0
3505005,2021,0,0,0,0,0,0
3505104,2021,0,0,0,0,0,0
3505203,2021,50,"1,5",43,"1,3",7,"0,2"
3505302,2021,91,"2,6",59,"1,7",32,"0,9"
3505351,2021,0,0,0,0,0,0
3505401,2021,0,0,0,0,0,0
3505500,2021,515,"4,3",393,"3,3",122,1
3505609,2021,0,0,0,0,0,0
3505708,2021,464,"1,7",388,"1,5",76,"0,3"
3505807,2021,30,"1,5",23,"1,1",7,"0,3"
3505906,2021,134,"2,2",102,"1,7",32,"0,5"
3506003,2021,1291,"3,5",689,"1,9",602,"1,6"
3506102,2021,149,2,84,"1,1",65,"0,9"
3506201,2021,0,0,0,0,0,0
3506300,2021,28,"2,6",28,"2,6",0,0
3506359,2021,50,"0,8",50,"0,8",0,0
3506409,2021,36,"4,6",35,"4,5",1,"0,1"
3506508,2021,146,"1,2",66,"0,5",80,"0,7"
3506607,2021,4,"0,1",4,"0,1",0,0
3506706,2021,16,"1,1",15,1,1,"0,1"
3506805,2021,35,"2,9",29,"2,4",6,"0,5"
3506904,2021,0,0,0,0,0,0
3507001,2021,53,"0,9",41,"0,7",12,"0,2"
3507100,2021,11,"0,4",11,"0,4",0,0
3507159,2021,0,0,0,0,0,0
3507209,2021,0,0,0,0,0,0
3507308,2021,0,0,0,0,0,0
3507407,2021,26,"1,7",16,1,10,"0,7"
3507456,2021,0,0,0,0,0,0
3507506,2021,744,"5,2",556,"3,9",188,"1,3"
3507605,2021,371,"2,2",212,"1,3",159,1
3507704,2021,0,0,0,0,0,0
3507753,2021,0,0,0,0,0,0
3507803,2021,0,0,0,0,0,0
3507902,2021,41,"1,7",35,"1,5",6,"0,2"
3508009,2021,0,0,0,0,0,0
3508108,2021,36,"2,2",18,"1,1",18,"1,1"
3508207,2021,0,0,0,0,0,0
3508306,2021,0,0,0,0,0,0
3508405,2021,66,"1,3",13,"0,3",53,"1,1"
3508504,2021,184,2,59,"0,6",125,"1,4"
3508603,2021,31,1,31,1,0,0
3508702,2021,62,"3,3",62,"3,3",0,0
3508801,2021,48,"2,8",37,"2,1",11,"0,6"
3508900,2021,0,0,0,0,0,0
3509007,2021,128,"1,3",74,"0,7",54,"0,5"
3509106,2021,0,0,0,0,0,0
3509205,2021,125,"1,6",25,"0,3",100,"1,3"
3509254,2021,0,0,0,0,0,0
3509304,2021,27,"2,7",21,"2,1",6,"0,6"
3509403,2021,140,"5,4",55,"2,1",85,"3,3"
3509452,2021,0,0,0,0,0,0
3509502,2021,2771,"2,3",1409,"1,2",1362,"1,2"
3509601,2021,54,"0,6",54,"0,6",0,0
3509700,2021,195,"3,9",185,"3,7",10,"0,2"
3509809,2021,0,0,0,0,0,0
3509908,2021,0,0,0,0,0,0
3509957,2021,0,0,0,0,0,0
3510005,2021,30,1,25,"0,8",5,"0,2"
3510104,2021,0,0,0,0,0,0
3510153,2021,0,0,0,0,0,0
3510203,2021,45,1,37,"0,8",8,"0,2"
3510302,2021,59,"2,8",14,"0,7",45,"2,2"
3510401,2021,110,2,61,"1,1",49,"0,9"
3510500,2021,308,"2,6",254,"2,2",54,"0,5"
3510609,2021,270,"0,7",220,"0,6",50,"0,1"
3510708,2021,31,"2,6",12,1,19,"1,6"
3510807,2021,386,"13,1",378,"12,8",8,"0,3"
3510906,2021,0,0,0,0,0,0
3511003,2021,31,"1,5",30,"1,4",1,0
3511102,2021,601,"5,1",374,"3,2",227,"1,9"
3511201,2021,0,0,0,0,0,0
3511300,2021,52,"5,8",0,0,52,"5,8"
3511409,2021,39,2,32,"1,7",7,"0,4"
3511508,2021,38,"0,8",26,"0,6",12,"0,3"
3511607,2021,27,"1,6",23,"1,3",4,"0,2"
3511706,2021,33,"1,9",26,"1,5",7,"0,4"
3511904,2021,24,"2,9",21,"2,5",3,"0,4"
3512001,2021,63,"3,6",51,"2,9",12,"0,7"
3512100,2021,20,"3,3",20,"3,3",0,0
3512209,2021,48,"1,7",36,"1,3",12,"0,4"
3512308,2021,12,"0,7",12,"0,7",0,0
3512407,2021,0,0,0,0,0,0
3512506,2021,0,0,0,0,0,0
3512605,2021,6,"1,2",6,"1,2",0,0
3512704,2021,1,"0,3",1,"0,3",0,0
3512803,2021,71,1,31,"0,4",40,"0,6"
3512902,2021,0,0,0,0,0,0
3513009,2021,363,"1,4",132,"0,5",231,"0,9"
3513108,2021,15,"0,4",13,"0,4",2,"0,1"
3513207,2021,0,0,0,0,0,0
3513306,2021,0,0,0,0,0,0
3513405,2021,105,"1,3",88,"1,1",17,"0,2"
3513504,2021,120,"0,9",96,"0,7",24,"0,2"
3513603,2021,40,"1,8",25,"1,2",15,"0,7"
3513702,2021,40,"1,2",32,1,8,"0,2"
3513801,2021,638,"1,6",569,"1,4",69,"0,2"
3513850,2021,0,0,0,0,0,0
3513900,2021,186,"17,1",186,"17,1",0,0
3514007,2021,0,0,0,0,0,0
3514106,2021,67,"2,5",47,"1,7",20,"0,7"
3514205,2021,0,0,0,0,0,0
3514304,2021,17,2,17,2,0,0
3514403,2021,150,"3,3",115,"2,6",35,"0,8"
3514502,2021,87,"7,3",77,"6,4",10,"0,8"
3514601,2021,0,0,0,0,0,0
3514700,2021,0,0,0,0,0,0
3514809,2021,2,"0,1",2,"0,1",0,0
3514908,2021,6,"0,3",6,"0,3",0,0
3514924,2021,0,0,0,0,0,0
3514957,2021,0,0,0,0,0,0
3515004,2021,219,"0,8",64,"0,2",155,"0,6"
3515103,2021,17,"0,2",17,"0,2",0,0
3515129,2021,0,0,0,0,0,0
3515152,2021,0,0,0,0,0,0
3515186,2021,446,"10,5",346,"8,1",100,"2,3"
3515194,2021,0,0,0,0,0,0
3515202,2021,37,"4,6",31,"3,8",6,"0,7"
3515301,2021,0,0,0,0,0,0
3515350,2021,0,0,0,0,0,0
3515400,2021,20,"1,3",12,"0,8",8,"0,5"
3515509,2021,135,2,84,"1,3",51,"0,8"
3515608,2021,0,0,0,0,0,0
3515657,2021,0,0,0,0,0,0
3515707,2021,189,1,189,1,0,0
3515806,2021,0,0,0,0,0,0
3515905,2021,0,0,0,0,0,0
3516002,2021,47,"3,9",30,"2,5",17,"1,4"
3516101,2021,0,0,0,0,0,0
3516200,2021,613,"1,8",428,"1,2",185,"0,5"
3516309,2021,164,"0,9",164,"0,9",0,0
3516408,2021,671,"4,4",621,4,50,"0,3"
3516507,2021,0,0,0,0,0,0
3516606,2021,45,"6,9",27,"4,1",18,"2,8"
3516705,2021,287,"6,8",258,"6,1",29,"0,7"
3516804,2021,0,0,0,0,0,0
3516853,2021,0,0,0,0,0,0
3516903,2021,28,"2,6",19,"1,8",9,"0,8"
3517000,2021,38,"3,5",36,"3,3",2,"0,2"
3517109,2021,0,0,0,0,0,0
3517208,2021,0,0,0,0,0,0
3517307,2021,0,0,0,0,0,0
3517406,2021,71,"1,8",53,"1,4",18,"0,5"
3517505,2021,0,0,0,0,0,0
3517604,2021,27,"1,5",27,"1,5",0,0
3517703,2021,48,"2,3",40,"1,9",8,"0,4"
3517802,2021,23,"2,7",15,"1,8",8,1
3517901,2021,0,0,0,0,0,0
3518008,2021,0,0,0,0,0,0
3518107,2021,0,0,0,0,0,0
3518206,2021,74,"2,3",48,"1,5",26,"0,8"
3518305,2021,33,"1,1",31,1,2,"0,1"
3518404,2021,277,"2,3",133,"1,1",144,"1,2"
3518503,2021,0,0,0,0,0,0
3518602,2021,66,"1,7",59,"1,5",7,"0,2"
3518701,2021,415,"1,3",312,1,103,"0,3"
3518800,2021,1935,"1,4",1496,"1,1",439,"0,3"
3518859,2021,0,0,0,0,0,0
3518909,2021,0,0,0,0,0,0
3519006,2021,58,"6,2",58,"6,2",0,0
3519055,2021,0,0,0,0,0,0
3519071,2021,99,"0,4",77,"0,3",22,"0,1"
3519105,2021,30,"2,6",28,"2,5",2,"0,2"
3519204,2021,0,0,0,0,0,0
3519253,2021,0,0,0,0,0,0
3519303,2021,27,"0,8",27,"0,8",0,0
3519402,2021,27,"2,2",9,"0,7",18,"1,5"
3519501,2021,0,0,0,0,0,0
3519600,2021,104,"1,8",47,"0,8",57,1
3519709,2021,217,"2,8",59,"0,8",158,"2,1"
3519808,2021,0,0,0,0,0,0
3519907,2021,18,"2,3",18,"2,3",0,0
3520004,2021,0,0,0,0,0,0
3520103,2021,43,"1,5",37,"1,3",6,"0,2"
3520202,2021,8,"0,9",8,"0,9",0,0
3520301,2021,9,"0,3",9,"0,3",0,0
3520400,2021,59,"1,7",59,"1,7",0,0
3520426,2021,0,0,0,0,0,0
3520442,2021,110,"4,3",74,"2,9",36,"1,4"
3520509,2021,379,"1,5",221,"0,9",158,"0,6"
3520608,2021,0,0,0,0,0,0
3520707,2021,36,"9,4",4,1,32,"8,3"
3520806,2021,0,0,0,0,0,0
3520905,2021,49,"3,4",38,"2,6",11,"0,8"
3521002,2021,15,"0,4",15,"0,4",0,0
3521101,2021,0,0,0,0,0,0
3521150,2021,0,0,0,0,0,0
3521200,2021,0,0,0,0,0,0
3521309,2021,39,"2,4",29,"1,8",10,"0,6"
3521408,2021,13,"0,5",13,"0,5",0,0
3521507,2021,0,0,0,0,0,0
3521606,2021,0,0,0,0,0,0
3521705,2021,19,"1,1",19,"1,1",0,0
3521804,2021,35,"1,3",35,"1,3",0,0
3521903,2021,50,"3,4",32,"2,2",18,"1,2"
3522000,2021,0,0,0,0,0,0
3522109,2021,135,"1,4",108,"1,1",27,"0,3"
3522158,2021,0,0,0,0,0,0
3522208,2021,647,"3,8",192,"1,1",455,"2,7"
3522307,2021,162,1,120,"0,7",42,"0,3"
3522406,2021,157,"1,7",112,"1,2",45,"0,5"
3522505,2021,397,"1,6",261,"1,1",136,"0,6"
3522604,2021,926,"12,9",565,"7,9",361,5
3522653,2021,0,0,0,0,0,0
3522703,2021,65,"1,6",39,"0,9",26,"0,6"
3522802,2021,41,"2,8",29,2,12,"0,8"
3522901,2021,30,"2,2",30,"2,2",0,0
3523008,2021,0,0,0,0,0,0
3523107,2021,253,"0,7",229,"0,6",24,"0,1"
3523206,2021,61,"1,2",51,1,10,"0,2"
3523305,2021,0,0,0,0,0,0
3523404,2021,120,1,61,"0,5",59,"0,5"
3523503,2021,14,"0,7",7,"0,3",7,"0,3"
3523602,2021,22,"1,3",22,"1,3",0,0
3523701,2021,0,0,0,0,0,0
3523800,2021,0,0,0,0,0,0
3523909,2021,298,"1,7",298,"1,7",0,0
3524006,2021,86,"1,4",48,"0,8",38,"0,6"
3524105,2021,120,3,53,"1,3",67,"1,7"
3524204,2021,17,"2,5",17,"2,5",0,0
3524303,2021,212,"2,9",49,"0,7",163,"2,2"
3524402,2021,363,"1,6",167,"0,7",196,"0,9"
3524501,2021,216,"30,6",149,"21,1",67,"9,5"
3524600,2021,0,0,0,0,0,0
3524709,2021,77,"1,4",75,"1,4",2,0
3524808,2021,151,"3,2",103,"2,2",48,1
3524907,2021,0,0,0,0,0,0
3525003,2021,18,"0,1",3,0,15,"0,1"
3525102,2021,0,0,0,0,0,0
3525201,2021,29,1,17,"0,6",12,"0,4"
3525300,2021,1025,"6,9",700,"4,7",325,"2,2"
3525409,2021,0,0,0,0,0,0
3525508,2021,11,"0,9",11,"0,9",0,0
3525607,2021,0,0,0,0,0,0
3525706,2021,67,"1,8",22,"0,6",45,"1,2"
3525805,2021,0,0,0,0,0,0
3525854,2021,0,0,0,0,0,0
3525904,2021,832,2,412,1,420,1
3526001,2021,46,"2,3",25,"1,2",21,1
3526100,2021,0,0,0,0,0,0
3526209,2021,20,"0,7",20,"0,7",0,0
3526308,2021,0,0,0,0,0,0
3526407,2021,46,"1,6",28,1,18,"0,6"
3526506,2021,0,0,0,0,0,0
3526605,2021,0,0,0,0,0,0
3526704,2021,122,"1,2",84,"0,8",38,"0,4"
3526803,2021,179,"2,7",53,"0,8",126,"1,9"
3526902,2021,361,"1,2",174,"0,6",187,"0,6"
3527009,2021,0,0,0,0,0,0
3527108,2021,442,"5,9",334,"4,4",108,"1,4"
3527207,2021,158,"1,8",68,"0,8",90,1
3527256,2021,0,0,0,0,0,0
3527306,2021,32,"0,7",28,"0,6",4,"0,1"
3527405,2021,36,"1,7",30,"1,4",6,"0,3"
3527504,2021,0,0,0,0,0,0
3527603,2021,0,0,0,0,0,0
3527702,2021,0,0,0,0,0,0
3527801,2021,0,0,0,0,0,0
3527900,2021,0,0,0,0,0,0
3528007,2021,31,"1,8",18,"1,1",13,"0,8"
3528106,2021,18,"2,3",15,"1,9",3,"0,4"
3528205,2021,0,0,0,0,0,0
3528304,2021,0,0,0,0,0,0
3528403,2021,0,0,0,0,0,0
3528502,2021,52,"0,5",46,"0,5",6,"0,1"
3528601,2021,0,0,0,0,0,0
3528700,2021,0,0,0,0,0,0
3528809,2021,26,"1,9",22,"1,6",4,"0,3"
3528858,2021,0,0,0,0,0,0
3528908,2021,0,0,0,0,0,0
3529005,2021,889,"3,8",688,3,201,"0,9"
3529104,2021,0,0,0,0,0,0
3529203,2021,45,"1,7",40,"1,6",5,"0,2"
3529302,2021,162,2,100,"1,2",62,"0,8"
3529401,2021,481,1,214,"0,5",267,"0,6"
3529500,2021,0,0,0,0,0,0
3529609,2021,0,0,0,0,0,0
3529658,2021,0,0,0,0,0,0
3529708,2021,95,"4,4",74,"3,4",21,1
3529807,2021,11,"0,9",11,"0,9",0,0
3529906,2021,0,0,0,0,0,0
3530003,2021,0,0,0,0,0,0
3530102,2021,68,"2,4",68,"2,4",0,0
3530201,2021,20,"1,1",20,"1,1",0,0
3530300,2021,81,"1,4",30,"0,5",51,"0,9"
3530409,2021,0,0,0,0,0,0
3530508,2021,125,"1,9",78,"1,2",47,"0,7"
3530607,2021,857,2,599,"1,4",258,"0,6"
3530706,2021,379,"2,5",187,"1,3",192,"1,3"
3530805,2021,186,"2,1",121,"1,3",65,"0,7"
3530904,2021,0,0,0,0,0,0
3531001,2021,0,0,0,0,0,0
3531100,2021,90,"1,6",36,"0,7",54,1
3531209,2021,0,0,0,0,0,0
3531308,2021,109,"2,2",58,"1,2",51,"1,1"
3531407,2021,80,"3,4",30,"1,3",50,"2,1"
3531506,2021,70,"3,9",51,"2,8",19,1
3531605,2021,0,0,0,0,0,0
3531704,2021,0,0,0,0,0,0
3531803,2021,35,"0,6",26,"0,4",9,"0,1"
3531902,2021,47,"1,4",41,"1,3",6,"0,2"
3532009,2021,19,"1,4",9,"0,7",10,"0,7"
3532058,2021,0,0,0,0,0,0
3532108,2021,0,0,0,0,0,0
3532157,2021,0,0,0,0,0,0
3532207,2021,0,0,0,0,0,0
3532306,2021,0,0,0,0,0,0
3532405,2021,20,"1,1",20,"1,1",0,0
3532504,2021,21,"2,4",10,"1,2",11,"1,3"
3532603,2021,129,12,35,"3,3",94,"8,7"
3532702,2021,0,0,0,0,0,0
3532801,2021,0,0,0,0,0,0
3532827,2021,0,0,0,0,0,0
3532843,2021,0,0,0,0,0,0
3532868,2021,0,0,0,0,0,0
3532900,2021,18,"1,7",13,"1,2",5,"0,5"
3533007,2021,62,"2,9",19,"0,9",43,2
3533106,2021,0,0,0,0,0,0
3533205,2021,0,0,0,0,0,0
3533254,2021,0,0,0,0,0,0
3533304,2021,0,0,0,0,0,0
3533403,2021,43,"0,7",43,"0,7",0,0
3533502,2021,83,"2,1",47,"1,2",36,"0,9"
3533601,2021,0,0,0,0,0,0
3533700,2021,0,0,0,0,0,0
3533809,2021,0,0,0,0,0,0
3533908,2021,79,"1,5",41,"0,8",38,"0,7"
3534005,2021,0,0,0,0,0,0
3534104,2021,0,0,0,0,0,0
3534203,2021,0,0,0,0,0,0
3534302,2021,98,"2,3",60,"1,4",38,"0,9"
3534401,2021,906,"1,3",608,"0,9",298,"0,4"
3534500,2021,0,0,0,0,0,0
3534609,2021,71,"2,3",47,"1,5",24,"0,8"
3534708,2021,162,"1,5",83,"0,7",79,"0,7"
3534757,2021,33,"3,3",28,"2,8",5,"0,5"
3534807,2021,0,0,0,0,0,0
3534906,2021,37,"2,8",32,"2,5",5,"0,4"
3535002,2021,0,0,0,0,0,0
3535101,2021,0,0,0,0,0,0
3535200,2021,25,"2,7",15,"1,6",10,"1,1"
3535309,2021,54,"2,5",36,"1,7",18,"0,8"
3535408,2021,31,2,31,2,0,0
3535507,2021,96,"2,2",73,"1,6",23,"0,5"
3535606,2021,0,0,0,0,0,0
3535705,2021,0,0,0,0,0,0
3535804,2021,15,"0,7",15,"0,7",0,0
3535903,2021,0,0,0,0,0,0
3536000,2021,32,"3,1",26,"2,5",6,"0,6"
3536109,2021,0,0,0,0,0,0
3536208,2021,166,"8,6",166,"8,6",0,0
3536257,2021,0,0,0,0,0,0
3536307,2021,35,"2,4",23,"1,6",12,"0,8"
3536406,2021,0,0,0,0,0,0
3536505,2021,118,"1,1",118,"1,1",0,0
3536570,2021,0,0,0,0,0,0
3536604,2021,24,"2,8",18,"2,1",6,"0,7"
3536703,2021,42,"0,9",36,"0,8",6,"0,1"
3536802,2021,0,0,0,0,0,0
3536901,2021,0,0,0,0,0,0
3537008,2021,64,"3,9",55,"3,4",9,"0,6"
3537107,2021,98,"2,1",98,"2,1",0,0
3537156,2021,0,0,0,0,0,0
3537206,2021,3,"0,3",3,"0,3",0,0
3537305,2021,151,"2,5",141,"2,3",10,"0,2"
3537404,2021,52,2,47,"1,8",5,"0,2"
3537503,2021,0,0,0,0,0,0
3537602,2021,14,"0,2",14,"0,2",0,0
3537701,2021,0,0,0,0,0,0
3537800,2021,79,"1,5",59,"1,1",20,"0,4"
3537909,2021,35,"1,2",27,1,8,"0,3"
3538006,2021,253,"1,5",127,"0,8",126,"0,8"
3538105,2021,0,0,0,0,0,0
3538204,2021,0,0,0,0,0,0
3538303,2021,0,0,0,0,0,0
3538501,2021,0,0,0,0,0,0
3538600,2021,51,"1,9",29,"1,1",22,"0,8"
3538709,2021,690,"1,8",335,"0,9",355,"0,9"
3538808,2021,68,"2,4",49,"1,7",19,"0,7"
3538907,2021,285,"12,2",84,"3,6",201,"8,6"
3539004,2021,45,"4,2",20,"1,8",25,"2,3"
3539103,2021,0,0,0,0,0,0
3539202,2021,0,0,0,0,0,0
3539301,2021,168,"2,3",59,"0,8",109,"1,5"
3539400,2021,44,"3,3",41,"3,1",3,"0,2"
3539509,2021,50,"1,3",32,"0,8",18,"0,5"
3539608,2021,0,0,0,0,0,0
3539707,2021,0,0,0,0,0,0
3539806,2021,10,"0,1",10,"0,1",0,0
3539905,2021,0,0,0,0,0,0
3540002,2021,31,"1,4",26,"1,2",5,"0,2"
3540101,2021,0,0,0,0,0,0
3540200,2021,25,"0,5",21,"0,4",4,"0,1"
3540259,2021,0,0,0,0,0,0
3540309,2021,0,0,0,0,0,0
3540408,2021,18,"4,5",7,"1,8",11,"2,8"
3540507,2021,0,0,0,0,0,0
3540606,2021,47,"0,9",35,"0,7",12,"0,2"
3540705,2021,55,1,33,"0,6",22,"0,4"
3540754,2021,0,0,0,0,0,0
3540804,2021,31,"1,9",27,"1,6",4,"0,2"
3540853,2021,0,0,0,0,0,0
3540903,2021,0,0,0,0,0,0
3541000,2021,339,"1,1",207,"0,6",132,"0,4"
3541059,2021,0,0,0,0,0,0
3541109,2021,0,0,0,0,0,0
3541208,2021,51,"3,7",40,"2,9",11,"0,8"
3541307,2021,78,"1,8",68,"1,6",10,"0,2"
3541406,2021,1095,"4,9",737,"3,3",358,"1,6"
3541505,2021,96,"2,5",60,"1,6",36,"0,9"
3541604,2021,37,"0,9",37,"0,9",0,0
3541653,2021,0,0,0,0,0,0
3541703,2021,0,0,0,0,0,0
3541802,2021,0,0,0,0,0,0
3541901,2021,19,"1,5",19,"1,5",0,0
3542008,2021,0,0,0,0,0,0
3542107,2021,0,0,0,0,0,0
3542206,2021,103,"3,6",71,"2,5",32,"1,1"
3542305,2021,0,0,0,0,0,0
3542404,2021,40,2,31,"1,6",9,"0,5"
3542503,2021,0,0,0,0,0,0
3542602,2021,182,"3,4",147,"2,7",35,"0,6"
3542701,2021,0,0,0,0,0,0
3542800,2021,0,0,0,0,0,0
3542909,2021,24,"1,8",18,"1,4",6,"0,5"
3543006,2021,32,"1,8",32,"1,8",0,0
3543105,2021,0,0,0,0,0,0
3543204,2021,0,0,0,0,0,0
3543238,2021,0,0,0,0,0,0
3543253,2021,0,0,0,0,0,0
3543303,2021,167,"1,4",53,"0,4",114,1
3543402,2021,2226,"3,2",1409,2,817,"1,2"
3543501,2021,0,0,0,0,0,0
3543600,2021,0,0,0,0,0,0
3543709,2021,0,0,0,0,0,0
3543808,2021,23,"2,4",20,"2,1",3,"0,3"
3543907,2021,350,"1,7",205,1,145,"0,7"
3544004,2021,36,1,32,"0,9",4,"0,1"
3544103,2021,0,0,0,0,0,0
3544202,2021,42,"3,7",26,"2,3",16,"1,4"
3544251,2021,80,"4,4",80,"4,4",0,0
3544301,2021,54,5,14,"1,3",40,"3,7"
3544400,2021,0,0,0,0,0,0
3544509,2021,0,0,0,0,0,0
3544608,2021,0,0,0,0,0,0
3544707,2021,0,0,0,0,0,0
3544806,2021,0,0,0,0,0,0
3544905,2021,30,"2,6",20,"1,7",10,"0,9"
3545001,2021,9,"0,5",9,"0,5",0,0
3545100,2021,0,0,0,0,0,0
3545159,2021,0,0,0,0,0,0
3545209,2021,160,"1,4",116,1,44,"0,4"
3545308,2021,52,"1,2",43,1,9,"0,2"
3545407,2021,34,"3,7",22,"2,4",12,"1,3"
3545506,2021,0,0,0,0,0,0
3545605,2021,24,"1,6",7,"0,5",17,"1,1"
3545704,2021,0,0,0,0,0,0
3545803,2021,164,"0,9",108,"0,6",56,"0,3"
3546009,2021,0,0,0,0,0,0
3546108,2021,0,0,0,0,0,0
3546207,2021,0,0,0,0,0,0
3546256,2021,0,0,0,0,0,0
3546306,2021,35,1,25,"0,7",10,"0,3"
3546405,2021,96,"2,1",55,"1,2",41,"0,9"
3546504,2021,0,0,0,0,0,0
3546603,2021,80,"2,6",58,"1,9",22,"0,7"
3546702,2021,0,0,0,0,0,0
3546801,2021,76,"1,4",64,"1,2",12,"0,2"
3546900,2021,8,"0,9",0,0,8,"0,9"
3547007,2021,6,1,6,1,0,0
3547106,2021,0,0,0,0,0,0
3547205,2021,0,0,0,0,0,0
3547304,2021,59,"0,4",59,"0,4",0,0
3547403,2021,0,0,0,0,0,0
3547502,2021,311,"11,8",288,"10,9",23,"0,9"
3547601,2021,32,"1,2",19,"0,7",13,"0,5"
3547650,2021,0,0,0,0,0,0
3547700,2021,56,"2,8",37,"1,8",19,"0,9"
3547809,2021,1526,"2,2",755,"1,1",771,"1,1"
3547908,2021,16,"2,4",16,"2,4",0,0
3548005,2021,0,0,0,0,0,0
3548054,2021,0,0,0,0,0,0
3548104,2021,0,0,0,0,0,0
3548203,2021,0,0,0,0,0,0
3548302,2021,0,0,0,0,0,0
3548401,2021,0,0,0,0,0,0
3548500,2021,1650,"3,8",766,"1,8",884,"2,1"
3548609,2021,40,"3,8",26,"2,5",14,"1,3"
3548708,2021,1878,"2,3",836,1,1042,"1,3"
3548807,2021,745,"4,9",177,"1,2",568,"3,8"
3548906,2021,525,"2,2",231,"0,9",294,"1,2"
3549003,2021,0,0,0,0,0,0
3549102,2021,199,"2,3",94,"1,1",105,"1,2"
3549201,2021,0,0,0,0,0,0
3549250,2021,0,0,0,0,0,0
3549300,2021,0,0,0,0,0,0
3549409,2021,115,"2,3",68,"1,3",47,"0,9"
3549508,2021,0,0,0,0,0,0
3549607,2021,0,0,0,0,0,0
3549706,2021,138,"2,6",78,"1,5",60,"1,1"
3549805,2021,2102,"4,7",894,2,1208,"2,7"
3549904,2021,1608,"2,2",731,1,877,"1,2"
3549953,2021,73,"4,6",13,"0,8",60,"3,8"
3550001,2021,11,1,10,"0,9",1,"0,1"
3550100,2021,26,"0,7",23,"0,6",3,"0,1"
3550209,2021,45,"1,4",45,"1,4",0,0
3550308,2021,29947,"2,5",15997,"1,3",13950,"1,2"
3550407,2021,62,"1,8",50,"1,5",12,"0,3"
3550506,2021,0,0,0,0,0,0
3550605,2021,268,3,62,"0,7",206,"2,3"
3550704,2021,90,1,84,1,6,"0,1"
3550803,2021,30,"2,5",26,"2,2",4,"0,3"
3550902,2021,40,"2,7",36,"2,4",4,"0,3"
3551009,2021,258,"0,7",158,"0,4",100,"0,3"
3551108,2021,0,0,0,0,0,0
3551207,2021,0,0,0,0,0,0
3551306,2021,0,0,0,0,0,0
3551405,2021,0,0,0,0,0,0
3551504,2021,125,"2,8",112,"2,5",13,"0,3"
3551603,2021,49,"1,8",33,"1,2",16,"0,6"
3551702,2021,136,"1,1",65,"0,5",71,"0,6"
3551801,2021,0,0,0,0,0,0
3551900,2021,0,0,0,0,0,0
3552007,2021,2,"0,3",2,"0,3",0,0
3552106,2021,70,"1,8",63,"1,6",7,"0,2"
3552205,2021,1449,"2,2",869,"1,3",580,"0,9"
3552304,2021,22,"2,8",20,"2,6",2,"0,3"
3552403,2021,201,"0,7",192,"0,7",9,0
3552502,2021,237,"0,8",86,"0,3",151,"0,5"
3552551,2021,0,0,0,0,0,0
3552601,2021,30,"2,5",11,"0,9",19,"1,6"
3552700,2021,35,"2,2",22,"1,4",13,"0,8"
3552809,2021,460,"1,6",299,1,161,"0,6"
3552908,2021,0,0,0,0,0,0
3553005,2021,29,"2,1",24,"1,8",5,"0,4"
3553104,2021,0,0,0,0,0,0
3553203,2021,4,"0,6",4,"0,6",0,0
3553302,2021,36,"1,6",28,"1,2",8,"0,4"
3553401,2021,72,"2,9",30,"1,2",42,"1,7"
3553500,2021,0,0,0,0,0,0
3553609,2021,14,"1,1",12,1,2,"0,2"
3553658,2021,0,0,0,0,0,0
3553708,2021,120,"2,2",72,"1,3",48,"0,9"
3553807,2021,49,"2,1",31,"1,3",18,"0,8"
3553856,2021,0,0,0,0,0,0
3553906,2021,0,0,0,0,0,0
3553955,2021,0,0,0,0,0,0
3554003,2021,105,"0,9",59,"0,5",46,"0,4"
3554102,2021,524,"1,7",330,"1,1",194,"0,6"
3554201,2021,0,0,0,0,0,0
3554300,2021,58,"2,6",52,"2,3",6,"0,3"
3554409,2021,34,"3,7",30,"3,3",4,"0,4"
3554508,2021,55,"1,3",33,"0,8",22,"0,5"
3554607,2021,0,0,0,0,0,0
3554656,2021,0,0,0,0,0,0
3554706,2021,20,"2,1",13,"1,3",7,"0,7"
3554755,2021,0,0,0,0,0,0
3554805,2021,0,0,0,0,0,0
3554904,2021,0,0,0,0,0,0
3554953,2021,0,0,0,0,0,0
3555000,2021,350,"5,6",334,"5,3",16,"0,3"
3555109,2021,48,"3,2",30,2,18,"1,2"
3555208,2021,0,0,0,0,0,0
3555307,2021,0,0,0,0,0,0
3555356,2021,0,0,0,0,0,0
3555406,2021,92,1,74,"0,8",18,"0,2"
3555505,2021,0,0,0,0,0,0
3555604,2021,0,0,0,0,0,0
3555703,2021,0,0,0,0,0,0
3555802,2021,26,3,24,"2,8",2,"0,2"
3555901,2021,0,0,0,0,0,0
3556008,2021,34,"2,6",11,"0,8",23,"1,7"
3556107,2021,0,0,0,0,0,0
3556206,2021,142,"1,1",56,"0,4",86,"0,7"
3556305,2021,55,"2,3",31,"1,3",24,1
3556354,2021,0,0,0,0,0,0
3556404,2021,50,"1,2",31,"0,7",19,"0,5"
3556453,2021,0,0,0,0,0,0
3556503,2021,35,"0,3",31,"0,3",4,0
3556602,2021,72,"6,9",0,0,72,"6,9"
3556701,2021,85,"1,1",62,"0,8",23,"0,3"
3556800,2021,48,"2,6",30,"1,6",18,1
3556909,2021,0,0,0,0,0,0
3556958,2021,0,0,0,0,0,0
3557006,2021,237,2,78,"0,6",159,"1,3"
3557105,2021,215,"2,3",115,"1,2",100,"1,1"
3557154,2021,0,0,0,0,0,0
3557204,2021,51,"4,2",30,"2,5",21,"1,7"
3557303,2021,0,0,0,0,0,0
3500105,2022,221,"6,5",192,"5,7",29,"0,9"
3500204,2022,0,0,0,0,0,0
3500303,2022,24,"0,7",24,"0,7",0,0
3500402,2022,0,0,0,0,0,0
3500501,2022,42,"2,3",30,"1,6",12,"0,6"
3500550,2022,0,0,0,0,0,0
3500600,2022,0,0,0,0,0,0
3500709,2022,54,"1,5",38,1,16,"0,4"
3500758,2022,0,0,0,0,0,0
3500808,2022,0,0,0,0,0,0
3500907,2022,0,0,0,0,0,0
3501004,2022,31,2,29,"1,9",2,"0,1"
3501103,2022,22,"5,5",19,"4,8",3,"0,8"
3501152,2022,120,"6,6",0,0,120,"6,6"
3501202,2022,0,0,0,0,0,0
3501301,2022,20,"0,8",18,"0,8",2,"0,1"
3501400,2022,0,0,0,0,0,0
3501509,2022,0,0,0,0,0,0
3501608,2022,486,"2,1",200,"0,8",286,"1,2"
3501707,2022,261,"6,3",261,"6,3",0,0
3501806,2022,0,0,0,0,0,0
3501905,2022,374,"5,3",216,"3,1",158,"2,3"
3502002,2022,0,0,0,0,0,0
3502101,2022,118,"2,1",83,"1,5",35,"0,6"
3502200,2022,57,"2,3",54,"2,2",3,"0,1"
3502309,2022,0,0,0,0,0,0
3502408,2022,0,0,0,0,0,0
3502507,2022,92,"2,6",69,"1,9",23,"0,6"
3502606,2022,14,"3,4",13,"3,2",1,"0,2"
3502705,2022,55,"2,2",51,"2,1",4,"0,2"
3502754,2022,0,0,0,0,0,0
3502804,2022,417,"2,2",253,"1,3",164,"0,9"
3502903,2022,330,"9,9",45,"1,4",285,"8,6"
3503000,2022,0,0,0,0,0,0
3503109,2022,6,1,6,1,0,0
3503158,2022,0,0,0,0,0,0
3503208,2022,536,"2,3",300,"1,3",236,1
3503307,2022,448,"3,4",205,"1,5",243,"1,8"
3503356,2022,0,0,0,0,0,0
3503406,2022,32,"3,9",15,"1,8",17,"2,1"
3503505,2022,0,0,0,0,0,0
3503604,2022,0,0,0,0,0,0
3503703,2022,0,0,0,0,0,0
3503802,2022,8,"0,1",8,"0,1",0,0
3503901,2022,39,"0,4",39,"0,4",0,0
3503950,2022,0,0,0,0,0,0
3504008,2022,277,"2,7",151,"1,5",126,"1,2"
3504107,2022,192,"1,4",55,"0,4",137,1
3504206,2022,44,3,35,"2,4",9,"0,6"
3504305,2022,0,0,0,0,0,0
3504404,2022,0,0,0,0,0,0
3504503,2022,172,2,126,"1,4",46,"0,5"
3504602,2022,0,0,0,0,0,0
3504701,2022,0,0,0,0,0,0
3504800,2022,0,0,0,0,0,0
3504909,2022,15,"1,4",15,"1,4",0,0
3505005,2022,0,0,0,0,0,0
3505104,2022,0,0,0,0,0,0
3505203,2022,58,"1,7",45,"1,3",13,"0,4"
3505302,2022,91,"2,6",59,"1,7",32,"0,9"
3505351,2022,0,0,0,0,0,0
3505401,2022,0,0,0,0,0,0
3505500,2022,486,"4,1",413,"3,5",73,"0,6"
3505609,2022,0,0,0,0,0,0
3505708,2022,510,"1,9",430,"1,6",80,"0,3"
3505807,2022,30,"1,5",23,"1,1",7,"0,3"
3505906,2022,133,"2,2",101,"1,7",32,"0,5"
3506003,2022,1377,"3,8",715,"1,9",662,"1,8"
3506102,2022,141,"1,9",76,1,65,"0,9"
3506201,2022,0,0,0,0,0,0
3506300,2022,28,"2,6",28,"2,6",0,0
3506359,2022,49,"0,7",49,"0,7",0,0
3506409,2022,36,"4,6",35,"4,4",1,"0,1"
3506508,2022,147,"1,2",66,"0,5",81,"0,7"
3506607,2022,4,"0,1",4,"0,1",0,0
3506706,2022,16,"1,1",15,1,1,"0,1"
3506805,2022,18,"1,5",18,"1,5",0,0
3506904,2022,0,0,0,0,0,0
3507001,2022,54,"0,9",39,"0,7",15,"0,3"
3507100,2022,11,"0,4",11,"0,4",0,0
3507159,2022,0,0,0,0,0,0
3507209,2022,0,0,0,0,0,0
3507308,2022,0,0,0,0,0,0
3507407,2022,26,"1,7",16,1,10,"0,6"
3507456,2022,0,0,0,0,0,0
3507506,2022,858,6,549,"3,8",309,"2,2"
3507605,2022,364,"2,2",203,"1,2",161,1
3507704,2022,0,0,0,0,0,0
3507753,2022,0,0,0,0,0,0
3507803,2022,0,0,0,0,0,0
3507902,2022,41,"1,7",35,"1,4",6,"0,2"
3508009,2022,0,0,0,0,0,0
3508108,2022,40,"2,4",26,"1,6",14,"0,8"
3508207,2022,0,0,0,0,0,0
3508306,2022,0,0,0,0,0,0
3508405,2022,65,"1,3",12,"0,2",53,1
3508504,2022,199,"2,2",75,"0,8",124,"1,3"
3508603,2022,32,1,32,1,0,0
3508702,2022,62,"3,3",62,"3,3",0,0
3508801,2022,48,"2,8",37,"2,1",11,"0,6"
3508900,2022,0,0,0,0,0,0
3509007,2022,133,"1,3",69,"0,7",64,"0,6"
3509106,2022,0,0,0,0,0,0
3509205,2022,139,"1,7",39,"0,5",100,"1,3"
3509254,2022,0,0,0,0,0,0
3509304,2022,32,"3,2",21,"2,1",11,"1,1"
3509403,2022,140,"5,4",55,"2,1",85,"3,3"
3509452,2022,0,0,0,0,0,0
3509502,2022,2646,"2,2",1370,"1,2",1276,"1,1"
3509601,2022,54,"0,6",54,"0,6",0,0
3509700,2022,195,"3,9",185,"3,7",10,"0,2"
3509809,2022,0,0,0,0,0,0
3509908,2022,0,0,0,0,0,0
3509957,2022,0,0,0,0,0,0
3510005,2022,30,1,25,"0,8",5,"0,2"
3510104,2022,0,0,0,0,0,0
3510153,2022,0,0,0,0,0,0
3510203,2022,45,1,37,"0,8",8,"0,2"
3510302,2022,59,"2,8",14,"0,7",45,"2,1"
3510401,2022,104,"1,9",61,"1,1",43,"0,8"
3510500,2022,322,"2,7",254,"2,2",68,"0,6"
3510609,2022,270,"0,7",220,"0,6",50,"0,1"
3510708,2022,31,"2,6",10,"0,9",21,"1,8"
3510807,2022,406,"13,7",398,"13,4",8,"0,3"
3510906,2022,0,0,0,0,0,0
3511003,2022,31,"1,5",30,"1,4",1,0
3511102,2022,592,5,374,"3,2",218,"1,9"
3511201,2022,0,0,0,0,0,0
3511300,2022,0,0,0,0,0,0
3511409,2022,39,2,32,"1,6",7,"0,4"
3511508,2022,38,"0,8",26,"0,5",12,"0,3"
3511607,2022,27,"1,5",23,"1,3",4,"0,2"
3511706,2022,33,"1,9",26,"1,5",7,"0,4"
3511904,2022,24,"2,8",21,"2,5",3,"0,4"
3512001,2022,54,"3,1",41,"2,3",13,"0,7"
3512100,2022,20,"3,3",20,"3,3",0,0
3512209,2022,52,"1,9",40,"1,4",12,"0,4"
3512308,2022,15,"0,9",14,"0,8",1,"0,1"
3512407,2022,0,0,0,0,0,0
3512506,2022,0,0,0,0,0,0
3512605,2022,2,"0,4",2,"0,4",0,0
3512704,2022,2,"0,5",2,"0,5",0,0
3512803,2022,61,"0,8",28,"0,4",33,"0,5"
3512902,2022,0,0,0,0,0,0
3513009,2022,526,"2,1",132,"0,5",394,"1,5"
3513108,2022,15,"0,4",13,"0,4",2,"0,1"
3513207,2022,0,0,0,0,0,0
3513306,2022,0,0,0,0,0,0
3513405,2022,121,"1,5",83,1,38,"0,5"
3513504,2022,84,"0,6",84,"0,6",0,0
3513603,2022,40,"1,8",25,"1,2",15,"0,7"
3513702,2022,40,"1,2",32,1,8,"0,2"
3513801,2022,632,"1,6",593,"1,5",39,"0,1"
3513850,2022,0,0,0,0,0,0
3513900,2022,186,"17,2",186,"17,2",0,0
3514007,2022,0,0,0,0,0,0
3514106,2022,67,"2,5",47,"1,7",20,"0,7"
3514205,2022,0,0,0,0,0,0
3514304,2022,17,2,17,2,0,0
3514403,2022,150,"3,3",115,"2,5",35,"0,8"
3514502,2022,87,"7,3",77,"6,5",10,"0,8"
3514601,2022,0,0,0,0,0,0
3514700,2022,0,0,0,0,0,0
3514809,2022,2,"0,1",2,"0,1",0,0
3514908,2022,6,"0,3",6,"0,3",0,0
3514924,2022,0,0,0,0,0,0
3514957,2022,0,0,0,0,0,0
3515004,2022,264,1,109,"0,4",155,"0,6"
3515103,2022,15,"0,2",15,"0,2",0,0
3515129,2022,0,0,0,0,0,0
3515152,2022,0,0,0,0,0,0
3515186,2022,422,"9,9",343,8,79,"1,8"
3515194,2022,0,0,0,0,0,0
3515202,2022,37,"4,6",31,"3,8",6,"0,7"
3515301,2022,0,0,0,0,0,0
3515350,2022,0,0,0,0,0,0
3515400,2022,20,"1,3",12,"0,8",8,"0,5"
3515509,2022,135,2,84,"1,3",51,"0,8"
3515608,2022,0,0,0,0,0,0
3515657,2022,0,0,0,0,0,0
3515707,2022,189,1,189,1,0,0
3515806,2022,0,0,0,0,0,0
3515905,2022,0,0,0,0,0,0
3516002,2022,47,"3,9",30,"2,5",17,"1,4"
3516101,2022,0,0,0,0,0,0
3516200,2022,535,"1,5",370,"1,1",165,"0,5"
3516309,2022,168,"0,9",168,"0,9",0,0
3516408,2022,434,"2,8",384,"2,5",50,"0,3"
3516507,2022,0,0,0,0,0,0
3516606,2022,45,"6,9",27,"4,1",18,"2,8"
3516705,2022,269,"6,4",240,"5,7",29,"0,7"
3516804,2022,0,0,0,0,0,0
3516853,2022,0,0,0,0,0,0
3516903,2022,28,"2,6",19,"1,8",9,"0,8"
3517000,2022,38,"3,5",36,"3,3",2,"0,2"
3517109,2022,0,0,0,0,0,0
3517208,2022,0,0,0,0,0,0
3517307,2022,0,0,0,0,0,0
3517406,2022,71,"1,8",53,"1,4",18,"0,5"
3517505,2022,0,0,0,0,0,0
3517604,2022,0,0,0,0,0,0
3517703,2022,60,"2,9",52,"2,5",8,"0,4"
3517802,2022,23,"2,7",15,"1,8",8,1
3517901,2022,0,0,0,0,0,0
3518008,2022,0,0,0,0,0,0
3518107,2022,0,0,0,0,0,0
3518206,2022,74,"2,3",48,"1,5",26,"0,8"
3518305,2022,31,1,29,1,2,"0,1"
3518404,2022,310,"2,6",183,"1,5",127,"1,1"
3518503,2022,0,0,0,0,0,0
3518602,2022,66,"1,7",59,"1,5",7,"0,2"
3518701,2022,447,"1,4",306,1,141,"0,4"
3518800,2022,1890,"1,4",1423,1,467,"0,3"
3518859,2022,0,0,0,0,0,0
3518909,2022,0,0,0,0,0,0
3519006,2022,58,"6,2",58,"6,2",0,0
3519055,2022,0,0,0,0,0,0
3519071,2022,119,"0,5",97,"0,4",22,"0,1"
3519105,2022,30,"2,6",28,"2,4",2,"0,2"
3519204,2022,0,0,0,0,0,0
3519253,2022,0,0,0,0,0,0
3519303,2022,37,1,27,"0,8",10,"0,3"
3519402,2022,27,"2,2",9,"0,7",18,"1,5"
3519501,2022,0,0,0,0,0,0
3519600,2022,104,"1,8",49,"0,8",55,"0,9"
3519709,2022,228,"2,9",70,"0,9",158,2
3519808,2022,0,0,0,0,0,0
3519907,2022,18,"2,3",18,"2,3",0,0
3520004,2022,0,0,0,0,0,0
3520103,2022,43,"1,4",37,"1,2",6,"0,2"
3520202,2022,8,"0,9",8,"0,9",0,0
3520301,2022,9,"0,3",9,"0,3",0,0
3520400,2022,39,"1,1",39,"1,1",0,0
3520426,2022,0,0,0,0,0,0
3520442,2022,110,"4,3",74,"2,9",36,"1,4"
3520509,2022,384,"1,5",228,"0,9",156,"0,6"
3520608,2022,0,0,0,0,0,0
3520707,2022,36,"9,4",4,1,32,"8,3"
3520806,2022,0,0,0,0,0,0
3520905,2022,49,"3,3",38,"2,6",11,"0,8"
3521002,2022,15,"0,4",15,"0,4",0,0
3521101,2022,0,0,0,0,0,0
3521150,2022,0,0,0,0,0,0
3521200,2022,0,0,0,0,0,0
3521309,2022,50,"3,1",43,"2,7",7,"0,4"
3521408,2022,3,"0,1",3,"0,1",0,0
3521507,2022,0,0,0,0,0,0
3521606,2022,0,0,0,0,0,0
3521705,2022,19,"1,1",19,"1,1",0,0
3521804,2022,35,"1,3",33,"1,2",2,"0,1"
3521903,2022,50,"3,4",35,"2,4",15,1
3522000,2022,0,0,0,0,0,0
3522109,2022,135,"1,3",135,"1,3",0,0
3522158,2022,0,0,0,0,0,0
3522208,2022,650,"3,8",195,"1,1",455,"2,6"
3522307,2022,152,"0,9",110,"0,7",42,"0,3"
3522406,2022,147,"1,6",102,"1,1",45,"0,5"
3522505,2022,360,"1,5",224,"0,9",136,"0,6"
3522604,2022,939,"13,1",560,"7,8",379,"5,3"
3522653,2022,0,0,0,0,0,0
3522703,2022,69,"1,7",43,1,26,"0,6"
3522802,2022,41,"2,8",29,2,12,"0,8"
3522901,2022,30,"2,1",30,"2,1",0,0
3523008,2022,0,0,0,0,0,0
3523107,2022,256,"0,7",250,"0,7",6,0
3523206,2022,78,"1,6",51,1,27,"0,5"
3523305,2022,0,0,0,0,0,0
3523404,2022,120,1,61,"0,5",59,"0,5"
3523503,2022,14,"0,7",7,"0,3",7,"0,3"
3523602,2022,10,"0,6",10,"0,6",0,0
3523701,2022,0,0,0,0,0,0
3523800,2022,0,0,0,0,0,0
3523909,2022,436,"2,5",351,2,85,"0,5"
3524006,2022,86,"1,4",48,"0,8",38,"0,6"
3524105,2022,120,3,53,"1,3",67,"1,7"
3524204,2022,17,"2,5",17,"2,5",0,0
3524303,2022,277,"3,7",46,"0,6",231,"3,1"
3524402,2022,363,"1,6",167,"0,7",196,"0,9"
3524501,2022,216,"30,3",149,"20,9",67,"9,4"
3524600,2022,0,0,0,0,0,0
3524709,2022,84,"1,5",84,"1,5",0,0
3524808,2022,151,"3,2",103,"2,2",48,1
3524907,2022,0,0,0,0,0,0
3525003,2022,15,"0,1",0,0,15,"0,1"
3525102,2022,0,0,0,0,0,0
3525201,2022,29,"0,9",17,"0,6",12,"0,4"
3525300,2022,996,"6,7",679,"4,5",317,"2,1"
3525409,2022,0,0,0,0,0,0
3525508,2022,11,"0,9",11,"0,9",0,0
3525607,2022,0,0,0,0,0,0
3525706,2022,67,"1,8",22,"0,6",45,"1,2"
3525805,2022,0,0,0,0,0,0
3525854,2022,0,0,0,0,0,0
3525904,2022,841,2,426,1,415,1
3526001,2022,46,"2,3",25,"1,2",21,1
3526100,2022,0,0,0,0,0,0
3526209,2022,1,0,1,0,0,0
3526308,2022,0,0,0,0,0,0
3526407,2022,46,"1,6",28,1,18,"0,6"
3526506,2022,0,0,0,0,0,0
3526605,2022,0,0,0,0,0,0
3526704,2022,135,"1,3",77,"0,8",58,"0,6"
3526803,2022,171,"2,6",44,"0,7",127,"1,9"
3526902,2022,390,"1,3",172,"0,6",218,"0,7"
3527009,2022,0,0,0,0,0,0
3527108,2022,417,"5,5",333,"4,4",84,"1,1"
3527207,2022,173,2,85,1,88,1
3527256,2022,0,0,0,0,0,0
3527306,2022,32,"0,6",28,"0,6",4,"0,1"
3527405,2022,36,"1,7",30,"1,4",6,"0,3"
3527504,2022,0,0,0,0,0,0
3527603,2022,0,0,0,0,0,0
3527702,2022,0,0,0,0,0,0
3527801,2022,0,0,0,0,0,0
3527900,2022,0,0,0,0,0,0
3528007,2022,31,"1,8",18,"1,1",13,"0,8"
3528106,2022,15,"1,9",10,"1,3",5,"0,6"
3528205,2022,0,0,0,0,0,0
3528304,2022,0,0,0,0,0,0
3528403,2022,0,0,0,0,0,0
3528502,2022,47,"0,5",41,"0,4",6,"0,1"
3528601,2022,0,0,0,0,0,0
3528700,2022,0,0,0,0,0,0
3528809,2022,26,"1,9",22,"1,6",4,"0,3"
3528858,2022,0,0,0,0,0,0
3528908,2022,0,0,0,0,0,0
3529005,2022,892,"3,8",687,"2,9",205,"0,9"
3529104,2022,0,0,0,0,0,0
3529203,2022,45,"1,7",40,"1,5",5,"0,2"
3529302,2022,152,"1,9",93,"1,2",59,"0,7"
3529401,2022,496,"1,1",229,"0,5",267,"0,6"
3529500,2022,0,0,0,0,0,0
3529609,2022,0,0,0,0,0,0
3529658,2022,0,0,0,0,0,0
3529708,2022,72,"3,3",51,"2,4",21,1
3529807,2022,11,"0,9",11,"0,9",0,0
3529906,2022,0,0,0,0,0,0
3530003,2022,0,0,0,0,0,0
3530102,2022,85,3,85,3,0,0
3530201,2022,23,"1,3",23,"1,3",0,0
3530300,2022,79,"1,4",28,"0,5",51,"0,9"
3530409,2022,0,0,0,0,0,0
3530508,2022,137,"2,1",78,"1,2",59,"0,9"
3530607,2022,852,"1,9",598,"1,4",254,"0,6"
3530706,2022,347,"2,3",155,1,192,"1,3"
3530805,2022,173,"1,9",109,"1,2",64,"0,7"
3530904,2022,0,0,0,0,0,0
3531001,2022,0,0,0,0,0,0
3531100,2022,90,"1,6",36,"0,6",54,1
3531209,2022,0,0,0,0,0,0
3531308,2022,94,"1,9",48,1,46,"0,9"
3531407,2022,80,"3,4",30,"1,3",50,"2,1"
3531506,2022,70,"3,9",51,"2,8",19,"1,1"
3531605,2022,0,0,0,0,0,0
3531704,2022,0,0,0,0,0,0
3531803,2022,35,"0,6",26,"0,4",9,"0,1"
3531902,2022,47,"1,4",35,"1,1",12,"0,4"
3532009,2022,19,"1,4",9,"0,7",10,"0,7"
3532058,2022,0,0,0,0,0,0
3532108,2022,0,0,0,0,0,0
3532157,2022,0,0,0,0,0,0
3532207,2022,0,0,0,0,0,0
3532306,2022,0,0,0,0,0,0
3532405,2022,20,"1,1",20,"1,1",0,0
3532504,2022,21,"2,5",10,"1,2",11,"1,3"
3532603,2022,129,12,35,"3,3",94,"8,8"
3532702,2022,0,0,0,0,0,0
3532801,2022,0,0,0,0,0,0
3532827,2022,0,0,0,0,0,0
3532843,2022,0,0,0,0,0,0
3532868,2022,0,0,0,0,0,0
3532900,2022,18,"1,6",13,"1,2",5,"0,5"
3533007,2022,62,"2,9",19,"0,9",43,2
3533106,2022,0,0,0,0,0,0
3533205,2022,0,0,0,0,0,0
3533254,2022,0,0,0,0,0,0
3533304,2022,0,0,0,0,0,0
3533403,2022,35,"0,6",35,"0,6",0,0
3533502,2022,83,"2,1",47,"1,2",36,"0,9"
3533601,2022,0,0,0,0,0,0
3533700,2022,0,0,0,0,0,0
3533809,2022,0,0,0,0,0,0
3533908,2022,79,"1,5",41,"0,8",38,"0,7"
3534005,2022,0,0,0,0,0,0
3534104,2022,0,0,0,0,0,0
3534203,2022,0,0,0,0,0,0
3534302,2022,98,"2,3",60,"1,4",38,"0,9"
3534401,2022,980,"1,4",682,1,298,"0,4"
3534500,2022,0,0,0,0,0,0
3534609,2022,72,"2,3",58,"1,9",14,"0,4"
3534708,2022,169,"1,5",97,"0,9",72,"0,6"
3534757,2022,33,"3,3",28,"2,8",5,"0,5"
3534807,2022,0,0,0,0,0,0
3534906,2022,37,"2,8",32,"2,5",5,"0,4"
3535002,2022,0,0,0,0,0,0
3535101,2022,0,0,0,0,0,0
3535200,2022,20,"2,2",10,"1,1",10,"1,1"
3535309,2022,43,2,27,"1,2",16,"0,7"
3535408,2022,31,2,31,2,0,0
3535507,2022,96,"2,2",73,"1,6",23,"0,5"
3535606,2022,0,0,0,0,0,0
3535705,2022,0,0,0,0,0,0
3535804,2022,15,"0,7",15,"0,7",0,0
3535903,2022,0,0,0,0,0,0
3536000,2022,32,"3,1",26,"2,5",6,"0,6"
3536109,2022,0,0,0,0,0,0
3536208,2022,166,"8,6",166,"8,6",0,0
3536257,2022,0,0,0,0,0,0
3536307,2022,35,"2,4",23,"1,6",12,"0,8"
3536406,2022,0,0,0,0,0,0
3536505,2022,118,"1,1",118,"1,1",0,0
3536570,2022,0,0,0,0,0,0
3536604,2022,11,"1,3",10,"1,2",1,"0,1"
3536703,2022,62,"1,3",60,"1,3",2,0
3536802,2022,0,0,0,0,0,0
3536901,2022,0,0,0,0,0,0
3537008,2022,64,"3,9",55,"3,4",9,"0,6"
3537107,2022,98,"2,1",98,"2,1",0,0
3537156,2022,0,0,0,0,0,0
3537206,2022,3,"0,3",3,"0,3",0,0
3537305,2022,180,"2,9",157,"2,6",23,"0,4"
3537404,2022,52,2,47,"1,8",5,"0,2"
3537503,2022,0,0,0,0,0,0
3537602,2022,18,"0,3",15,"0,2",3,0
3537701,2022,0,0,0,0,0,0
3537800,2022,79,"1,5",59,"1,1",20,"0,4"
3537909,2022,35,"1,2",27,"0,9",8,"0,3"
3538006,2022,255,"1,5",129,"0,8",126,"0,8"
3538105,2022,0,0,0,0,0,0
3538204,2022,0,0,0,0,0,0
3538303,2022,0,0,0,0,0,0
3538501,2022,0,0,0,0,0,0
3538600,2022,42,"1,6",28,"1,1",14,"0,5"
3538709,2022,760,"1,9",405,1,355,"0,9"
3538808,2022,68,"2,4",49,"1,7",19,"0,7"
3538907,2022,290,"12,5",85,"3,6",205,"8,8"
3539004,2022,45,"4,2",20,"1,8",25,"2,3"
3539103,2022,0,0,0,0,0,0
3539202,2022,0,0,0,0,0,0
3539301,2022,178,"2,4",66,"0,9",112,"1,5"
3539400,2022,23,"1,7",21,"1,6",2,"0,1"
3539509,2022,50,"1,3",32,"0,8",18,"0,5"
3539608,2022,0,0,0,0,0,0
3539707,2022,0,0,0,0,0,0
3539806,2022,10,"0,1",10,"0,1",0,0
3539905,2022,0,0,0,0,0,0
3540002,2022,26,"1,2",19,"0,9",7,"0,3"
3540101,2022,0,0,0,0,0,0
3540200,2022,25,"0,5",21,"0,4",4,"0,1"
3540259,2022,0,0,0,0,0,0
3540309,2022,0,0,0,0,0,0
3540408,2022,18,"4,5",6,"1,5",12,3
3540507,2022,0,0,0,0,0,0
3540606,2022,63,"1,2",45,"0,9",18,"0,3"
3540705,2022,55,1,33,"0,6",22,"0,4"
3540754,2022,0,0,0,0,0,0
3540804,2022,32,"1,9",28,"1,7",4,"0,2"
3540853,2022,0,0,0,0,0,0
3540903,2022,0,0,0,0,0,0
3541000,2022,339,1,207,"0,6",132,"0,4"
3541059,2022,0,0,0,0,0,0
3541109,2022,0,0,0,0,0,0
3541208,2022,51,"3,7",40,"2,9",11,"0,8"
3541307,2022,78,"1,8",68,"1,6",10,"0,2"
3541406,2022,1095,"4,9",735,"3,3",360,"1,6"
3541505,2022,102,"2,7",62,"1,6",40,"1,1"
3541604,2022,64,"1,6",64,"1,6",0,0
3541653,2022,0,0,0,0,0,0
3541703,2022,0,0,0,0,0,0
3541802,2022,0,0,0,0,0,0
3541901,2022,19,"1,5",19,"1,5",0,0
3542008,2022,0,0,0,0,0,0
3542107,2022,0,0,0,0,0,0
3542206,2022,103,"3,6",71,"2,5",32,"1,1"
3542305,2022,0,0,0,0,0,0
3542404,2022,40,2,31,"1,6",9,"0,5"
3542503,2022,0,0,0,0,0,0
3542602,2022,237,"4,4",192,"3,5",45,"0,8"
3542701,2022,0,0,0,0,0,0
3542800,2022,0,0,0,0,0,0
3542909,2022,24,"1,8",18,"1,4",6,"0,5"
3543006,2022,26,"1,5",26,"1,5",0,0
3543105,2022,0,0,0,0,0,0
3543204,2022,0,0,0,0,0,0
3543238,2022,0,0,0,0,0,0
3543253,2022,0,0,0,0,0,0
3543303,2022,164,"1,4",50,"0,4",114,1
3543402,2022,2265,"3,3",1422,2,843,"1,2"
3543501,2022,0,0,0,0,0,0
3543600,2022,0,0,0,0,0,0
3543709,2022,0,0,0,0,0,0
3543808,2022,23,"2,4",20,"2,1",3,"0,3"
3543907,2022,369,"1,8",218,"1,1",151,"0,7"
3544004,2022,72,2,64,"1,8",8,"0,2"
3544103,2022,0,0,0,0,0,0
3544202,2022,36,"3,1",25,"2,2",11,1
3544251,2022,80,"4,4",80,"4,4",0,0
3544301,2022,54,5,14,"1,3",40,"3,7"
3544400,2022,0,0,0,0,0,0
3544509,2022,0,0,0,0,0,0
3544608,2022,0,0,0,0,0,0
3544707,2022,0,0,0,0,0,0
3544806,2022,0,0,0,0,0,0
3544905,2022,30,"2,6",20,"1,7",10,"0,9"
3545001,2022,9,"0,5",9,"0,5",0,0
3545100,2022,0,0,0,0,0,0
3545159,2022,0,0,0,0,0,0
3545209,2022,116,1,116,1,0,0
3545308,2022,52,"1,2",43,1,9,"0,2"
3545407,2022,34,"3,7",22,"2,4",12,"1,3"
3545506,2022,0,0,0,0,0,0
3545605,2022,19,"1,3",11,"0,7",8,"0,5"
3545704,2022,0,0,0,0,0,0
3545803,2022,196,1,116,"0,6",80,"0,4"
3546009,2022,0,0,0,0,0,0
3546108,2022,0,0,0,0,0,0
3546207,2022,0,0,0,0,0,0
3546256,2022,0,0,0,0,0,0
3546306,2022,35,1,25,"0,7",10,"0,3"
3546405,2022,96,"2,1",55,"1,2",41,"0,9"
3546504,2022,0,0,0,0,0,0
3546603,2022,80,"2,6",63,2,17,"0,5"
3546702,2022,0,0,0,0,0,0
3546801,2022,86,"1,5",74,"1,3",12,"0,2"
3546900,2022,8,"0,9",0,0,8,"0,9"
3547007,2022,6,1,6,1,0,0
3547106,2022,0,0,0,0,0,0
3547205,2022,0,0,0,0,0,0
3547304,2022,61,"0,4",61,"0,4",0,0
3547403,2022,0,0,0,0,0,0
3547502,2022,311,"11,8",288,"10,9",23,"0,9"
3547601,2022,32,"1,2",19,"0,7",13,"0,5"
3547650,2022,0,0,0,0,0,0
3547700,2022,56,"2,8",37,"1,8",19,"0,9"
3547809,2022,1575,"2,3",742,"1,1",833,"1,2"
3547908,2022,16,"2,4",16,"2,4",0,0
3548005,2022,0,0,0,0,0,0
3548054,2022,0,0,0,0,0,0
3548104,2022,0,0,0,0,0,0
3548203,2022,0,0,0,0,0,0
3548302,2022,0,0,0,0,0,0
3548401,2022,0,0,0,0,0,0
3548500,2022,1609,"3,7",720,"1,7",889,"2,1"
3548609,2022,40,"3,8",26,"2,5",14,"1,3"
3548708,2022,1743,"2,1",719,"0,9",1024,"1,3"
3548807,2022,795,"5,3",177,"1,2",618,"4,1"
3548906,2022,409,"1,7",167,"0,7",242,1
3549003,2022,0,0,0,0,0,0
3549102,2022,199,"2,3",94,"1,1",105,"1,2"
3549201,2022,0,0,0,0,0,0
3549250,2022,0,0,0,0,0,0
3549300,2022,0,0,0,0,0,0
3549409,2022,104,2,63,"1,2",41,"0,8"
3549508,2022,0,0,0,0,0,0
3549607,2022,0,0,0,0,0,0
3549706,2022,141,"2,6",80,"1,5",61,"1,1"
3549805,2022,2148,"4,7",1070,"2,4",1078,"2,4"
3549904,2022,1588,"2,2",730,1,858,"1,2"
3549953,2022,60,"3,8",0,0,60,"3,8"
3550001,2022,25,"2,4",16,"1,5",9,"0,8"
3550100,2022,58,"1,5",42,"1,1",16,"0,4"
3550209,2022,65,2,65,2,0,0
3550308,2022,29764,"2,5",15418,"1,3",14346,"1,2"
3550407,2022,63,"1,8",51,"1,5",12,"0,3"
3550506,2022,0,0,0,0,0,0
3550605,2022,275,"3,1",62,"0,7",213,"2,4"
3550704,2022,111,"1,2",99,"1,1",12,"0,1"
3550803,2022,30,"2,5",26,"2,2",4,"0,3"
3550902,2022,40,"2,7",36,"2,4",4,"0,3"
3551009,2022,276,"0,8",176,"0,5",100,"0,3"
3551108,2022,0,0,0,0,0,0
3551207,2022,0,0,0,0,0,0
3551306,2022,0,0,0,0,0,0
3551405,2022,0,0,0,0,0,0
3551504,2022,125,"2,8",112,"2,5",13,"0,3"
3551603,2022,49,"1,8",33,"1,2",16,"0,6"
3551702,2022,131,"1,1",61,"0,5",70,"0,6"
3551801,2022,0,0,0,0,0,0
3551900,2022,0,0,0,0,0,0
3552007,2022,2,"0,3",2,"0,3",0,0
3552106,2022,70,"1,8",63,"1,6",7,"0,2"
3552205,2022,1421,"2,1",875,"1,3",546,"0,8"
3552304,2022,22,"2,8",20,"2,6",2,"0,3"
3552403,2022,201,"0,7",192,"0,7",9,0
3552502,2022,272,"0,9",111,"0,4",161,"0,5"
3552551,2022,0,0,0,0,0,0
3552601,2022,30,"2,5",11,"0,9",19,"1,6"
3552700,2022,35,"2,2",22,"1,4",13,"0,8"
3552809,2022,450,"1,5",289,1,161,"0,6"
3552908,2022,0,0,0,0,0,0
3553005,2022,29,"2,1",24,"1,8",5,"0,4"
3553104,2022,0,0,0,0,0,0
3553203,2022,4,"0,6",4,"0,6",0,0
3553302,2022,36,"1,6",28,"1,2",8,"0,3"
3553401,2022,72,"2,9",30,"1,2",42,"1,7"
3553500,2022,0,0,0,0,0,0
3553609,2022,16,"1,3",15,"1,2",1,"0,1"
3553658,2022,0,0,0,0,0,0
3553708,2022,122,"2,2",74,"1,4",48,"0,9"
3553807,2022,47,2,32,"1,4",15,"0,6"
3553856,2022,0,0,0,0,0,0
3553906,2022,0,0,0,0,0,0
3553955,2022,0,0,0,0,0,0
3554003,2022,105,"0,9",59,"0,5",46,"0,4"
3554102,2022,516,"1,7",366,"1,2",150,"0,5"
3554201,2022,0,0,0,0,0,0
3554300,2022,58,"2,6",52,"2,3",6,"0,3"
3554409,2022,34,"3,7",30,"3,3",4,"0,4"
3554508,2022,55,"1,3",33,"0,8",22,"0,5"
3554607,2022,0,0,0,0,0,0
3554656,2022,0,0,0,0,0,0
3554706,2022,20,2,13,"1,3",7,"0,7"
3554755,2022,0,0,0,0,0,0
3554805,2022,10,"0,2",0,0,10,"0,2"
3554904,2022,0,0,0,0,0,0
3554953,2022,0,0,0,0,0,0
3555000,2022,340,"5,4",324,"5,2",16,"0,3"
3555109,2022,48,"3,2",30,2,18,"1,2"
3555208,2022,0,0,0,0,0,0
3555307,2022,0,0,0,0,0,0
3555356,2022,0,0,0,0,0,0
3555406,2022,92,1,74,"0,8",18,"0,2"
3555505,2022,0,0,0,0,0,0
3555604,2022,0,0,0,0,0,0
3555703,2022,0,0,0,0,0,0
3555802,2022,26,3,24,"2,8",2,"0,2"
3555901,2022,0,0,0,0,0,0
3556008,2022,34,"2,6",11,"0,8",23,"1,7"
3556107,2022,0,0,0,0,0,0
3556206,2022,142,"1,1",56,"0,4",86,"0,7"
3556305,2022,55,"2,3",31,"1,3",24,1
3556354,2022,0,0,0,0,0,0
3556404,2022,50,"1,2",31,"0,7",19,"0,5"
3556453,2022,40,"0,7",0,0,40,"0,7"
3556503,2022,33,"0,3",31,"0,3",2,0
3556602,2022,72,"6,9",0,0,72,"6,9"
3556701,2022,85,"1,1",62,"0,8",23,"0,3"
3556800,2022,48,"2,6",30,"1,6",18,1
3556909,2022,0,0,0,0,0,0
3556958,2022,0,0,0,0,0,0
3557006,2022,102,"0,8",64,"0,5",38,"0,3"
3557105,2022,219,"2,4",115,"1,2",104,"1,1"
3557154,2022,0,0,0,0,0,0
3557204,2022,51,"4,2",30,"2,5",21,"1,7"
3557303,2022,0,0,0,0,0,0
3500105,2023,195,"5,62",138,"3,98",57,"1,64"
3500303,2023,24,"0,75",24,"0,75",0,0
3500501,2023,42,"2,34",30,"1,67",12,"0,67"
3500709,2023,54,"1,43",38,1,16,"0,42"
3501004,2023,21,"1,24",19,"1,13",2,"0,12"
3501103,2023,22,"5,79",19,5,3,"0,79"
3501152,2023,120,"6,95",0,0,120,"6,95"
3501301,2023,18,"0,65",16,"0,58",2,"0,07"
3501608,2023,440,"1,84",154,"0,64",286,"1,2"
3501707,2023,253,"7,72",253,"7,72",0,0
3501905,2023,374,"5,5",216,"3,18",158,"2,32"
3502101,2023,108,"1,8",69,"1,15",39,"0,65"
3502200,2023,57,"2,36",54,"2,24",3,"0,12"
3502507,2023,92,"2,85",69,"2,14",23,"0,71"
3502606,2023,14,"3,47",13,"3,22",1,"0,25"
3502705,2023,51,"2,08",45,"1,84",6,"0,25"
3502804,2023,418,"2,08",269,"1,34",149,"0,74"
3502903,2023,330,"10,05",45,"1,37",285,"8,68"
3503109,2023,6,"0,87",6,"0,87",0,0
3503208,2023,484,"1,98",254,"1,04",230,"0,94"
3503307,2023,418,"3,18",165,"1,26",253,"1,92"
3503406,2023,32,"3,93",15,"1,84",17,"2,09"
3503802,2023,8,"0,15",8,"0,15",0,0
3503901,2023,36,"0,41",36,"0,41",0,0
3504008,2023,277,"2,72",151,"1,49",126,"1,24"
3504107,2023,266,"1,65",60,"0,37",206,"1,28"
3504206,2023,44,"3,23",35,"2,57",9,"0,66"
3504503,2023,178,"1,91",132,"1,41",46,"0,49"
3504909,2023,15,"1,51",15,"1,51",0,0
3505203,2023,58,"1,84",45,"1,43",13,"0,41"
3505302,2023,51,"1,49",36,"1,05",15,"0,44"
3505500,2023,486,"3,95",413,"3,35",73,"0,59"
3505708,2023,524,"1,63",430,"1,34",94,"0,29"
3505807,2023,30,"1,39",23,"1,07",7,"0,32"
3505906,2023,133,"2,28",101,"1,73",32,"0,55"
3506003,2023,1329,"3,49",761,2,568,"1,49"
3506102,2023,175,"2,29",137,"1,79",38,"0,5"
3506300,2023,23,"1,97",23,"1,97",0,0
3506359,2023,49,"0,75",49,"0,75",0,0
3506409,2023,36,"4,93",35,"4,79",1,"0,14"
3506508,2023,148,"1,24",66,"0,55",82,"0,69"
3506607,2023,13,"0,44",13,"0,44",0,0
3506706,2023,16,"1,24",15,"1,16",1,"0,08"
3506805,2023,18,"1,6",18,"1,6",0,0
3507001,2023,54,"0,87",39,"0,63",15,"0,24"
3507100,2023,11,"0,5",11,"0,5",0,0
3507407,2023,26,"1,83",16,"1,13",10,"0,71"
3507506,2023,820,"5,61",511,"3,49",309,"2,11"
3507605,2023,364,"2,03",203,"1,13",161,"0,9"
3507902,2023,41,"1,71",35,"1,46",6,"0,25"
3508108,2023,40,"2,31",26,"1,5",14,"0,81"
3508405,2023,66,"1,39",15,"0,32",51,"1,08"
3508504,2023,199,"2,06",75,"0,77",124,"1,28"
3508603,2023,32,"1,01",32,"1,01",0,0
3508702,2023,50,"2,95",50,"2,95",0,0
3508801,2023,45,"2,71",34,"2,05",11,"0,66"
3509007,2023,122,"1,28",69,"0,72",53,"0,56"
3509205,2023,139,"1,47",39,"0,41",100,"1,05"
3509304,2023,32,"3,53",21,"2,32",11,"1,21"
3509403,2023,140,"5,88",55,"2,31",85,"3,57"
3509502,2023,2785,"2,44",1371,"1,2",1414,"1,24"
3509601,2023,54,"0,7",54,"0,7",0,0
3509700,2023,195,"4,17",185,"3,95",10,"0,21"
3510005,2023,30,"1,02",25,"0,85",5,"0,17"
3510203,2023,45,"0,97",37,"0,8",8,"0,17"
3510302,2023,59,"2,54",14,"0,6",45,"1,94"
3510401,2023,104,"2,08",61,"1,22",43,"0,86"
3510500,2023,327,"2,38",259,"1,89",68,"0,5"
3510609,2023,270,"0,7",220,"0,57",50,"0,13"
3510708,2023,31,"2,74",10,"0,89",21,"1,86"
3510807,2023,406,"14,49",398,"14,2",8,"0,29"
3511003,2023,31,"1,54",30,"1,49",1,"0,05"
3511102,2023,622,"5,37",374,"3,23",248,"2,14"
3511409,2023,38,"1,75",35,"1,61",3,"0,14"
3511508,2023,38,"0,85",26,"0,58",12,"0,27"
3511607,2023,27,"1,4",23,"1,19",4,"0,21"
3511706,2023,33,"2,12",26,"1,67",7,"0,45"
3511904,2023,24,"3,45",21,"3,02",3,"0,43"
3512001,2023,54,"2,91",41,"2,21",13,"0,7"
3512100,2023,20,3,20,3,0,0
3512209,2023,52,"1,84",40,"1,42",12,"0,42"
3512308,2023,15,"0,99",14,"0,93",1,"0,07"
3512605,2023,2,"0,48",2,"0,48",0,0
3512704,2023,2,"0,48",2,"0,48",0,0
3512803,2023,61,"1,02",28,"0,47",33,"0,55"
3513009,2023,518,"1,85",133,"0,48",385,"1,38"
3513108,2023,15,"0,45",13,"0,39",2,"0,06"
3513405,2023,121,"1,62",83,"1,11",38,"0,51"
3513504,2023,119,"1,07",119,"1,07",0,0
3513603,2023,40,"1,81",25,"1,13",15,"0,68"
3513702,2023,40,"1,26",25,"0,79",15,"0,47"
3513801,2023,594,"1,51",555,"1,42",39,"0,1"
3513900,2023,186,"16,73",186,"16,73",0,0
3514106,2023,67,"2,74",47,"1,92",20,"0,82"
3514304,2023,15,"1,86",15,"1,86",0,0
3514403,2023,143,"3,14",108,"2,37",35,"0,77"
3514502,2023,87,"7,05",77,"6,24",10,"0,81"
3514809,2023,2,"0,16",2,"0,16",0,0
3514908,2023,6,"0,34",6,"0,34",0,0
3515004,2023,244,"0,97",89,"0,36",155,"0,62"
3515103,2023,15,"0,22",15,"0,22",0,0
3515186,2023,415,"10,48",336,"8,49",79,2
3515202,2023,51,"5,37",45,"4,74",6,"0,63"
3515400,2023,20,"1,2",12,"0,72",8,"0,48"
3515509,2023,135,"1,88",84,"1,17",51,"0,71"
3515707,2023,189,"1,05",189,"1,05",0,0
3516002,2023,47,"3,64",30,"2,32",17,"1,32"
3516200,2023,565,"1,59",404,"1,14",161,"0,45"
3516309,2023,168,"1,02",168,"1,02",0,0
3516408,2023,434,"2,98",384,"2,64",50,"0,34"
3516606,2023,45,"7,14",27,"4,28",18,"2,85"
3516705,2023,269,"6,41",240,"5,72",29,"0,69"
3516903,2023,28,"2,72",19,"1,85",9,"0,88"
3517000,2023,38,"3,74",36,"3,54",2,"0,2"
3517406,2023,71,"1,8",53,"1,35",18,"0,46"
3517703,2023,60,"3,25",52,"2,82",8,"0,43"
3517802,2023,23,"3,14",15,"2,05",8,"1,09"
3518206,2023,74,"2,39",48,"1,55",26,"0,84"
3518305,2023,31,"0,98",29,"0,92",2,"0,06"
3518404,2023,283,"2,39",166,"1,4",117,"0,99"
3518602,2023,61,"1,63",53,"1,41",8,"0,21"
3518701,2023,447,"1,56",306,"1,07",141,"0,49"
3518800,2023,1901,"1,47",1423,"1,1",478,"0,37"
3519006,2023,58,"6,34",58,"6,34",0,0
3519071,2023,106,"0,44",84,"0,35",22,"0,09"
3519105,2023,30,"2,87",28,"2,68",2,"0,19"
3519303,2023,38,"1,18",27,"0,84",11,"0,34"
3519402,2023,27,"2,3",9,"0,77",18,"1,53"
3519600,2023,104,"1,72",49,"0,81",55,"0,91"
3519709,2023,245,"3,23",70,"0,92",175,"2,31"
3519907,2023,18,"2,37",18,"2,37",0,0
3520103,2023,43,"1,65",32,"1,23",11,"0,42"
3520202,2023,8,"0,75",8,"0,75",0,0
3520400,2023,39,"1,1",39,"1,1",0,0
3520442,2023,110,"4,31",74,"2,9",36,"1,41"
3520509,2023,454,"1,75",270,"1,04",184,"0,71"
3520707,2023,36,"8,9",4,"0,99",32,"7,91"
3520905,2023,49,"3,58",28,"2,04",21,"1,53"
3521002,2023,15,"0,41",15,"0,41",0,0
3521101,2023,1,"0,15",0,0,1,"0,15"
3521309,2023,50,"3,46",43,"2,98",7,"0,48"
3521408,2023,3,"0,14",3,"0,14",0,0
3521705,2023,19,"1,06",19,"1,06",0,0
3521804,2023,31,"1,23",31,"1,23",0,0
3521903,2023,50,"2,91",35,"2,03",15,"0,87"
3522109,2023,145,"1,27",145,"1,27",0,0
3522208,2023,633,4,195,"1,23",438,"2,77"
3522307,2023,191,"1,2",148,"0,93",43,"0,27"
3522406,2023,147,"1,64",102,"1,14",45,"0,5"
3522505,2023,360,"1,54",224,"0,96",136,"0,58"
3522604,2023,927,"12,84",538,"7,45",389,"5,39"
3522703,2023,69,"1,75",43,"1,09",26,"0,66"
3522802,2023,41,"2,93",29,"2,07",12,"0,86"
3522901,2023,35,"2,54",35,"2,54",0,0
3523107,2023,273,"0,73",267,"0,72",6,"0,02"
3523206,2023,78,"1,77",51,"1,16",27,"0,61"
3523404,2023,120,"0,98",61,"0,5",59,"0,48"
3523503,2023,14,"0,73",7,"0,37",7,"0,37"
3523602,2023,10,"0,62",10,"0,62",0,0
3523909,2023,465,"2,75",351,"2,08",114,"0,67"
3524006,2023,86,"1,18",48,"0,66",38,"0,52"
3524105,2023,120,"3,21",53,"1,42",67,"1,79"
3524204,2023,17,"2,75",17,"2,75",0,0
3524303,2023,277,"3,86",46,"0,64",231,"3,22"
3524402,2023,354,"1,46",165,"0,68",189,"0,78"
3524501,2023,216,"27,92",168,"21,72",48,"6,2"
3524709,2023,84,"1,39",84,"1,39",0,0
3524808,2023,151,"3,09",103,"2,11",48,"0,98"
3525003,2023,15,"0,13",0,0,15,"0,13"
3525201,2023,29,"0,75",17,"0,44",12,"0,31"
3525300,2023,876,"6,56",569,"4,26",307,"2,3"
3525508,2023,11,"0,86",11,"0,86",0,0
3525706,2023,67,"1,82",37,1,30,"0,81"
3525904,2023,876,"1,96",464,"1,04",412,"0,92"
3526001,2023,46,"2,24",25,"1,22",21,"1,02"
3526209,2023,1,"0,04",1,"0,04",0,0
3526407,2023,46,"1,75",28,"1,06",18,"0,68"
3526704,2023,135,"1,37",77,"0,78",58,"0,59"
3526803,2023,171,"2,56",44,"0,66",127,"1,9"
3526902,2023,386,"1,32",172,"0,59",214,"0,73"
3527108,2023,369,"4,93",279,"3,73",90,"1,2"
3527207,2023,200,"2,36",85,1,115,"1,36"
3527306,2023,32,"0,6",28,"0,53",4,"0,08"
3527405,2023,36,"1,8",30,"1,5",6,"0,3"
3528007,2023,31,"1,84",18,"1,07",13,"0,77"
3528106,2023,15,"2,02",10,"1,34",5,"0,67"
3528502,2023,44,"0,47",44,"0,47",0,0
3528809,2023,26,"2,07",22,"1,75",4,"0,32"
3529005,2023,855,"3,58",572,"2,4",283,"1,19"
3529203,2023,45,"1,81",40,"1,61",5,"0,2"
3529302,2023,151,"1,91",87,"1,1",64,"0,81"
3529401,2023,528,"1,27",261,"0,63",267,"0,64"
3529708,2023,72,"3,73",51,"2,64",21,"1,09"
3529807,2023,11,"0,99",11,"0,99",0,0
3530102,2023,88,"3,15",88,"3,15",0,0
3530201,2023,23,"1,46",23,"1,46",0,0
3530300,2023,79,"1,23",28,"0,44",51,"0,8"
3530508,2023,137,"2,03",78,"1,15",59,"0,87"
3530607,2023,848,"1,86",591,"1,3",257,"0,56"
3530706,2023,347,"2,25",155,1,192,"1,24"
3530805,2023,172,"1,85",109,"1,17",63,"0,68"
3531100,2023,36,"0,57",36,"0,57",0,0
3531308,2023,96,"2,02",49,"1,03",47,"0,99"
3531407,2023,80,"3,58",30,"1,34",50,"2,24"
3531506,2023,70,"3,88",51,"2,83",19,"1,05"
3531803,2023,35,"0,53",26,"0,4",9,"0,14"
3531902,2023,47,"1,69",35,"1,26",12,"0,43"
3532009,2023,9,"0,65",8,"0,58",1,"0,07"
3532405,2023,20,"1,09",20,"1,09",0,0
3532504,2023,21,"2,16",10,"1,03",11,"1,13"
3532603,2023,129,"13,21",35,"3,58",94,"9,63"
3532900,2023,18,"1,94",13,"1,4",5,"0,54"
3533007,2023,62,"3,2",19,"0,98",43,"2,22"
3533403,2023,35,"0,56",35,"0,56",0,0
3533502,2023,73,"1,9",41,"1,07",32,"0,83"
3533908,2023,79,"1,43",47,"0,85",32,"0,58"
3534302,2023,98,"2,57",60,"1,58",38,1
3534401,2023,949,"1,3",629,"0,86",320,"0,44"
3534609,2023,72,"2,3",58,"1,86",14,"0,45"
3534708,2023,167,"1,61",97,"0,94",70,"0,68"
3534757,2023,33,"3,17",28,"2,69",5,"0,48"
3535200,2023,20,"2,26",12,"1,36",8,"0,9"
3535309,2023,43,"2,21",29,"1,49",14,"0,72"
3535507,2023,96,"2,35",73,"1,79",23,"0,56"
3535804,2023,15,"0,77",15,"0,77",0,0
3536000,2023,32,"3,04",26,"2,47",6,"0,57"
3536208,2023,154,8,154,8,0,0
3536307,2023,35,"2,4",23,"1,58",12,"0,82"
3536505,2023,79,"0,7",79,"0,7",0,0
3536604,2023,24,"3,28",18,"2,46",6,"0,82"
3536703,2023,62,"1,38",54,"1,2",8,"0,18"
3537008,2023,64,"4,13",55,"3,55",9,"0,58"
3537107,2023,85,"1,97",75,"1,74",10,"0,23"
3537206,2023,3,"0,26",3,"0,26",0,0
3537305,2023,138,"2,23",120,"1,94",18,"0,29"
3537404,2023,52,"2,17",47,"1,96",5,"0,21"
3537602,2023,18,"0,26",15,"0,22",3,"0,04"
3537800,2023,79,"1,49",59,"1,12",20,"0,38"
3537909,2023,35,"1,27",27,"0,98",8,"0,29"
3538006,2023,255,"1,53",129,"0,77",126,"0,76"
3538600,2023,42,"1,61",28,"1,07",14,"0,54"
3538709,2023,732,"1,71",375,"0,88",357,"0,84"
3538808,2023,68,"2,31",49,"1,67",19,"0,65"
3538907,2023,290,"12,99",85,"3,81",205,"9,18"
3539004,2023,47,"4,31",22,"2,02",25,"2,29"
3539301,2023,127,"1,72",67,"0,91",60,"0,81"
3539400,2023,23,"1,5",21,"1,37",2,"0,13"
3539509,2023,56,"1,67",32,"0,96",24,"0,72"
3539806,2023,10,"0,1",10,"0,1",0,0
3540002,2023,26,"1,29",19,"0,94",7,"0,35"
3540200,2023,23,"0,62",19,"0,51",4,"0,11"
3540408,2023,18,"4,37",6,"1,46",12,"2,92"
3540606,2023,63,"1,11",45,"0,79",18,"0,32"
3540705,2023,55,"1,05",33,"0,63",22,"0,42"
3540804,2023,32,"1,71",28,"1,5",4,"0,21"
3541000,2023,378,"1,06",216,"0,61",162,"0,45"
3541208,2023,51,"3,51",40,"2,76",11,"0,76"
3541307,2023,78,"1,99",68,"1,73",10,"0,25"
3541406,2023,1095,"4,84",735,"3,25",360,"1,59"
3541505,2023,102,"2,93",62,"1,78",40,"1,15"
3541604,2023,64,"1,83",64,"1,83",0,0
3541901,2023,19,"2,12",19,"2,12",0,0
3542206,2023,103,"3,61",71,"2,49",32,"1,12"
3542404,2023,40,"1,98",31,"1,53",9,"0,44"
3542602,2023,242,"4,02",195,"3,24",47,"0,78"
3542909,2023,13,"1,2",10,"0,92",3,"0,28"
3543006,2023,26,"1,4",26,"1,4",0,0
3543303,2023,156,"1,35",42,"0,36",114,"0,99"
3543402,2023,2242,"3,18",1425,"2,02",817,"1,16"
3543808,2023,23,"2,5",20,"2,17",3,"0,33"
3543907,2023,387,"1,91",210,"1,04",177,"0,88"
3544004,2023,72,"2,29",64,"2,04",8,"0,25"
3544202,2023,36,"3,51",25,"2,44",11,"1,07"
3544251,2023,80,"4,65",80,"4,65",0,0
3544301,2023,14,"1,28",14,"1,28",0,0
3544905,2023,30,"2,62",20,"1,75",10,"0,87"
3545001,2023,9,"0,59",9,"0,59",0,0
3545209,2023,116,"0,85",116,"0,85",0,0
3545308,2023,52,"1,18",43,"0,98",9,"0,2"
3545407,2023,34,"3,76",22,"2,43",12,"1,33"
3545605,2023,19,"1,36",11,"0,79",8,"0,57"
3545803,2023,196,"1,07",116,"0,63",80,"0,44"
3546306,2023,35,"1,22",25,"0,87",10,"0,35"
3546405,2023,96,"2,06",55,"1,18",41,"0,88"
3546603,2023,81,"2,3",58,"1,65",23,"0,65"
3546801,2023,82,"1,54",71,"1,33",11,"0,21"
3546900,2023,8,"1,13",0,0,8,"1,13"
3547007,2023,6,"1,15",6,"1,15",0,0
3547304,2023,62,"0,39",62,"0,39",0,0
3547502,2023,265,"10,74",253,"10,26",12,"0,49"
3547601,2023,32,"1,37",19,"0,82",13,"0,56"
3547700,2023,56,"3,16",37,"2,09",19,"1,07"
3547809,2023,1560,"2,07",763,"1,01",797,"1,06"
3547908,2023,9,"1,32",9,"1,32",0,0
3548500,2023,1627,"3,89",720,"1,72",907,"2,17"
3548609,2023,40,"3,41",26,"2,22",14,"1,19"
3548708,2023,1761,"2,17",719,"0,89",1042,"1,28"
3548807,2023,795,"4,78",177,"1,06",618,"3,71"
3548906,2023,417,"1,62",171,"0,67",246,"0,96"
3549102,2023,199,"2,14",94,"1,01",105,"1,13"
3549409,2023,104,"2,14",63,"1,29",41,"0,84"
3549706,2023,141,"2,71",79,"1,52",62,"1,19"
3549805,2023,2169,"4,47",1050,"2,16",1119,"2,31"
3549904,2023,1590,"2,27",735,"1,05",855,"1,22"
3549953,2023,60,"3,71",0,0,60,"3,71"
3550001,2023,25,"2,42",16,"1,55",9,"0,87"
3550100,2023,58,"1,56",42,"1,13",16,"0,43"
3550209,2023,80,"2,5",80,"2,5",0,0
3550308,2023,30293,"2,65",15409,"1,35",14884,"1,3"
3550407,2023,63,"1,63",51,"1,32",12,"0,31"
3550605,2023,274,"3,45",62,"0,78",212,"2,67"
3550704,2023,111,"1,35",99,"1,21",12,"0,15"
3550803,2023,30,"2,91",26,"2,53",4,"0,39"
3550902,2023,40,3,36,"2,7",4,"0,3"
3551009,2023,283,"0,86",182,"0,55",101,"0,31"
3551504,2023,84,"1,9",82,"1,85",2,"0,05"
3551603,2023,49,"1,63",33,"1,1",16,"0,53"
3551702,2023,134,"1,05",61,"0,48",73,"0,57"
3552007,2023,2,"0,32",2,"0,32",0,0
3552106,2023,70,"1,74",63,"1,57",7,"0,17"
3552205,2023,1627,"2,22",904,"1,23",723,"0,99"
3552304,2023,22,"3,01",20,"2,73",2,"0,27"
3552403,2023,191,"0,68",182,"0,65",9,"0,03"
3552502,2023,352,"1,13",191,"0,62",161,"0,52"
3552601,2023,30,"2,65",11,"0,97",19,"1,68"
3552700,2023,35,"2,38",22,"1,49",13,"0,88"
3552809,2023,450,"1,64",289,"1,05",161,"0,59"
3553005,2023,29,"2,27",24,"1,88",5,"0,39"
3553203,2023,4,"0,6",4,"0,6",0,0
3553302,2023,36,"1,69",28,"1,31",8,"0,38"
3553401,2023,72,"2,84",30,"1,18",42,"1,66"
3553609,2023,16,"1,37",15,"1,28",1,"0,09"
3553708,2023,122,"2,35",74,"1,42",48,"0,92"
3553807,2023,47,"1,92",32,"1,31",15,"0,61"
3554003,2023,129,"1,03",78,"0,62",51,"0,41"
3554102,2023,516,"1,65",366,"1,17",150,"0,48"
3554300,2023,58,"2,62",52,"2,35",6,"0,27"
3554409,2023,34,"4,32",30,"3,82",4,"0,51"
3554508,2023,55,"1,46",33,"0,88",22,"0,58"
3554706,2023,20,"2,15",13,"1,39",7,"0,75"
3554805,2023,10,"0,19",0,0,10,"0,19"
3555000,2023,340,"5,33",324,"5,08",16,"0,25"
3555109,2023,48,"3,01",30,"1,88",18,"1,13"
3555406,2023,86,"0,91",83,"0,88",3,"0,03"
3555802,2023,26,"2,95",24,"2,72",2,"0,23"
3556008,2023,20,"1,45",10,"0,72",10,"0,72"
3556206,2023,142,"1,11",56,"0,44",86,"0,67"
3556305,2023,55,"2,26",31,"1,28",24,"0,99"
3556404,2023,50,"1,25",31,"0,77",19,"0,47"
3556503,2023,33,"0,28",31,"0,27",2,"0,02"
3556602,2023,72,"7,11",0,0,72,"7,11"
3556701,2023,85,"1,1",62,"0,8",23,"0,3"
3556800,2023,48,"2,76",30,"1,72",18,"1,03"
3557006,2023,102,"0,79",64,"0,5",38,"0,29"
3557105,2023,211,"2,16",115,"1,18",96,"0,98"
3557204,2023,51,"4,19",30,"2,47",21,"1,73"